Country,Year,Age,PopMale,PopFemale,PopTotal,RelMasc
Portugal,1950,0,99577,93035,192612,107.0318
Portugal,1950,1,96148,91627,187775,104.9341
Portugal,1950,2,89627,85899,175526,104.34
Portugal,1950,3,91402,87692,179094,104.2307
Portugal,1950,4,87462,83775,171237,104.4011
Portugal,1950,5,85505,82596,168101,103.522
Portugal,1950,6,84283,81761,166044,103.0846
Portugal,1950,7,77068,73720,150788,104.5415
Portugal,1950,8,73408,70898,144306,103.5403
Portugal,1950,9,76866,74267,151133,103.4995
Portugal,1950,10,77990,75112,153102,103.8316
Portugal,1950,11,84678,81831,166509,103.4791
Portugal,1950,12,80613,79213,159826,101.7674
Portugal,1950,13,84793,81559,166352,103.9652
Portugal,1950,14,81424,80431,161855,101.2346
Portugal,1950,15,81265,81233,162498,100.0394
Portugal,1950,16,82519,82005,164524,100.6268
Portugal,1950,17,85558,86138,171696,99.3267
Portugal,1950,18,76204,77244,153448,98.6536
Portugal,1950,19,75290,79903,155193,94.2267
Portugal,1950,20,78527,72354,150881,108.5317
Portugal,1950,21,78982,79109,158091,99.8395
Portugal,1950,22,74881,75384,150265,99.3327
Portugal,1950,23,75470,76202,151672,99.0394
Portugal,1950,24,72664,75257,147921,96.5545
Portugal,1950,25,70550,73558,144108,95.9107
Portugal,1950,26,68197,70741,138938,96.4038
Portugal,1950,27,67881,69939,137820,97.0574
Portugal,1950,28,59634,60439,120073,98.6681
Portugal,1950,29,66159,69808,135967,94.7728
Portugal,1950,30,46875,47005,93880,99.7234
Portugal,1950,31,50774,53796,104570,94.3825
Portugal,1950,32,52665,55508,108173,94.8782
Portugal,1950,33,51753,55459,107212,93.3176
Portugal,1950,34,54923,58359,113282,94.1123
Portugal,1950,35,55292,59603,114895,92.7671
Portugal,1950,36,54399,58382,112781,93.1777
Portugal,1950,37,58223,63356,121579,91.8982
Portugal,1950,38,52605,55934,108539,94.0483
Portugal,1950,39,60676,67120,127796,90.3993
Portugal,1950,40,44475,47085,91560,94.4568
Portugal,1950,41,52691,57832,110523,91.1105
Portugal,1950,42,46800,53228,100028,87.9236
Portugal,1950,43,45456,52779,98235,86.1252
Portugal,1950,44,47206,53954,101160,87.493
Portugal,1950,45,42287,50094,92381,84.4153
Portugal,1950,46,41156,48921,90077,84.1275
Portugal,1950,47,43661,53128,96789,82.1808
Portugal,1950,48,38819,44991,83810,86.2817
Portugal,1950,49,47132,58004,105136,81.2565
Portugal,1950,50,31294,36052,67346,86.8024
Portugal,1950,51,35832,43812,79644,81.7858
Portugal,1950,52,32266,39703,71969,81.2684
Portugal,1950,53,31351,38909,70260,80.5752
Portugal,1950,54,32793,40913,73706,80.153
Portugal,1950,55,31268,39485,70753,79.1896
Portugal,1950,56,28595,35922,64517,79.603
Portugal,1950,57,30626,39782,70408,76.9846
Portugal,1950,58,25705,31868,57573,80.6609
Portugal,1950,59,33495,47019,80514,71.2372
Portugal,1950,60,21594,26630,48224,81.089
Portugal,1950,61,26201,34188,60389,76.638
Portugal,1950,62,24424,32204,56628,75.8415
Portugal,1950,63,22977,31477,54454,72.9962
Portugal,1950,64,22944,32857,55801,69.8299
Portugal,1950,65,22169,30889,53058,71.7699
Portugal,1950,66,18966,26349,45315,71.98
Portugal,1950,67,19269,28213,47482,68.2983
Portugal,1950,68,15188,20272,35460,74.9211
Portugal,1950,69,21339,32484,53823,65.6908
Portugal,1950,70,12041,15947,27988,75.5064
Portugal,1950,71,14668,21188,35856,69.2279
Portugal,1950,72,13447,18381,31828,73.1571
Portugal,1950,73,11963,17369,29332,68.8756
Portugal,1950,74,12194,19717,31911,61.8451
Portugal,1950,75,10204,15783,25987,64.6518
Portugal,1950,76,8574,13247,21821,64.7241
Portugal,1950,77,8499,14131,22630,60.1444
Portugal,1950,78,5448,8593,14041,63.4004
Portugal,1950,79,7522,14120,21642,53.272
Portugal,1950,80,5149,9715,14864,53.0005
Portugal,1950,81,4262,8371,12633,50.9139
Portugal,1950,82,3622,7463,11085,48.5328
Portugal,1950,83,3003,6407,9410,46.8706
Portugal,1950,84,2431,5450,7881,44.6055
Portugal,1950,85,1913,4628,6541,41.3354
Portugal,1950,86,1488,3773,5261,39.4381
Portugal,1950,87,1153,3033,4186,38.0152
Portugal,1950,88,913,2508,3421,36.4035
Portugal,1950,89,723,2050,2773,35.2683
Portugal,1950,90,522,1574,2096,33.1639
Portugal,1950,91,371,1174,1545,31.6014
Portugal,1950,92,252,929,1181,27.1259
Portugal,1950,93,182,702,884,25.9259
Portugal,1950,94,140,576,716,24.3056
Portugal,1950,95,113,436,549,25.9174
Portugal,1950,96,90,299,389,30.1003
Portugal,1950,97,54,226,280,23.8938
Portugal,1950,98,38,150,188,25.3333
Portugal,1950,99,25,94,119,26.5957
Portugal,1950,100,32,202,234,15.8416
Portugal,1951,0,89974,85091,175065,105.7386
Portugal,1951,1,91154,86526,177680,105.3487
Portugal,1951,2,92088,88779,180867,103.7272
Portugal,1951,3,89323,86223,175546,103.5953
Portugal,1951,4,91541,88402,179943,103.5508
Portugal,1951,5,86773,83414,170187,104.0269
Portugal,1951,6,85280,82912,168192,102.856
Portugal,1951,7,84533,82147,166680,102.9045
Portugal,1951,8,77068,73704,150772,104.5642
Portugal,1951,9,73309,70866,144175,103.4474
Portugal,1951,10,77651,75395,153046,102.9922
Portugal,1951,11,78375,75540,153915,103.753
Portugal,1951,12,84723,82005,166728,103.3144
Portugal,1951,13,79740,78677,158417,101.3511
Portugal,1951,14,84726,81449,166175,104.0234
Portugal,1951,15,80599,80045,160644,100.6921
Portugal,1951,16,80600,81061,161661,99.4313
Portugal,1951,17,82008,81788,163796,100.269
Portugal,1951,18,85572,86486,172058,98.9432
Portugal,1951,19,75649,77172,152821,98.0265
Portugal,1951,20,73866,79576,153442,92.8245
Portugal,1951,21,78529,72122,150651,108.8836
Portugal,1951,22,78258,78659,156917,99.4902
Portugal,1951,23,74442,75165,149607,99.0381
Portugal,1951,24,74708,75842,150550,98.5048
Portugal,1951,25,71739,74940,146679,95.7286
Portugal,1951,26,69819,72980,142799,95.6687
Portugal,1951,27,67444,70274,137718,95.9729
Portugal,1951,28,66957,69045,136002,96.9759
Portugal,1951,29,59116,59922,119038,98.6549
Portugal,1951,30,65854,69310,135164,95.0137
Portugal,1951,31,45187,46247,91434,97.708
Portugal,1951,32,50007,53088,103095,94.1964
Portugal,1951,33,51629,54751,106380,94.2978
Portugal,1951,34,50716,54677,105393,92.7556
Portugal,1951,35,53999,57523,111522,93.8738
Portugal,1951,36,54707,59195,113902,92.4183
Portugal,1951,37,53852,57968,111820,92.8995
Portugal,1951,38,57752,63036,120788,91.6175
Portugal,1951,39,52695,56218,108913,93.7333
Portugal,1951,40,60051,66567,126618,90.2114
Portugal,1951,41,44162,46927,91089,94.1079
Portugal,1951,42,52492,57739,110231,90.9126
Portugal,1951,43,46278,52806,99084,87.6378
Portugal,1951,44,45216,52772,97988,85.6818
Portugal,1951,45,46792,53356,100148,87.6977
Portugal,1951,46,41737,49555,91292,84.2236
Portugal,1951,47,40797,48721,89518,83.736
Portugal,1951,48,43265,52905,96170,81.7787
Portugal,1951,49,38498,44877,83375,85.7856
Portugal,1951,50,46473,57489,103962,80.8381
Portugal,1951,51,31135,36028,67163,86.4189
Portugal,1951,52,35434,43493,78927,81.4706
Portugal,1951,53,31931,39424,71355,80.9938
Portugal,1951,54,30937,38608,69545,80.1311
Portugal,1951,55,32048,40298,72346,79.5275
Portugal,1951,56,30931,39387,70318,78.531
Portugal,1951,57,28149,35617,63766,79.0325
Portugal,1951,58,29972,39105,69077,76.6449
Portugal,1951,59,25235,31401,56636,80.3637
Portugal,1951,60,32694,46221,78915,70.7341
Portugal,1951,61,21084,26175,47259,80.5501
Portugal,1951,62,25499,33523,59022,76.0642
Portugal,1951,63,23845,31669,55514,75.2945
Portugal,1951,64,22380,30982,53362,72.2355
Portugal,1951,65,22129,32199,54328,68.7257
Portugal,1951,66,21479,30225,51704,71.0637
Portugal,1951,67,18423,25901,44324,71.1285
Portugal,1951,68,18440,27404,45844,67.2894
Portugal,1951,69,14576,19734,34310,73.8624
Portugal,1951,70,19831,30604,50435,64.7987
Portugal,1951,71,11358,15260,26618,74.4299
Portugal,1951,72,13876,20425,34301,67.9364
Portugal,1951,73,12425,17225,29650,72.1335
Portugal,1951,74,11076,16358,27434,67.71
Portugal,1951,75,11159,18357,29516,60.7888
Portugal,1951,76,9215,14573,23788,63.2334
Portugal,1951,77,7908,12415,20323,63.6971
Portugal,1951,78,7696,13081,20777,58.8334
Portugal,1951,79,4953,7976,12929,62.0988
Portugal,1951,80,5329,10102,15431,52.7519
Portugal,1951,81,4487,8707,13194,51.5332
Portugal,1951,82,3703,7533,11236,49.157
Portugal,1951,83,3074,6587,9661,46.6677
Portugal,1951,84,2489,5598,8087,44.4623
Portugal,1951,85,1962,4633,6595,42.3484
Portugal,1951,86,1546,3844,5390,40.2185
Portugal,1951,87,1185,3124,4309,37.9321
Portugal,1951,88,883,2478,3361,35.6336
Portugal,1951,89,688,2029,2717,33.9083
Portugal,1951,90,537,1622,2159,33.1073
Portugal,1951,91,385,1237,1622,31.1237
Portugal,1951,92,279,966,1245,28.882
Portugal,1951,93,186,740,926,25.1351
Portugal,1951,94,137,559,696,24.5081
Portugal,1951,95,103,444,547,23.1982
Portugal,1951,96,75,333,408,22.5225
Portugal,1951,97,55,227,282,24.2291
Portugal,1951,98,33,155,188,21.2903
Portugal,1951,99,22,100,122,22
Portugal,1951,100,33,196,229,16.8367
Portugal,1952,0,100220,93962,194182,106.6601
Portugal,1952,1,85954,81935,167889,104.9051
Portugal,1952,2,89239,84850,174089,105.1727
Portugal,1952,3,91224,88059,179283,103.5942
Portugal,1952,4,88227,85463,173690,103.2341
Portugal,1952,5,90305,87510,177815,103.1939
Portugal,1952,6,86195,83321,169516,103.4493
Portugal,1952,7,84441,82533,166974,102.3118
Portugal,1952,8,83479,81589,165068,102.3165
Portugal,1952,9,76319,73665,149984,103.6028
Portugal,1952,10,72225,70471,142696,102.489
Portugal,1952,11,76666,75242,151908,101.8926
Portugal,1952,12,76906,75296,152202,102.1382
Portugal,1952,13,83104,81216,164320,102.3247
Portugal,1952,14,78502,78077,156579,100.5443
Portugal,1952,15,83101,80658,163759,103.0288
Portugal,1952,16,79247,79328,158575,99.8979
Portugal,1952,17,78936,79861,158797,98.8417
Portugal,1952,18,80241,80585,160826,99.5731
Portugal,1952,19,83603,84916,168519,98.4538
Portugal,1952,20,74189,75837,150026,97.8269
Portugal,1952,21,72998,78750,151748,92.6959
Portugal,1952,22,76480,71121,147601,107.535
Portugal,1952,23,76387,77362,153749,98.7397
Portugal,1952,24,72816,74087,146903,98.2844
Portugal,1952,25,73145,74705,147850,97.9118
Portugal,1952,26,70561,73973,144534,95.3875
Portugal,1952,27,68652,72002,140654,95.3474
Portugal,1952,28,66170,69154,135324,95.685
Portugal,1952,29,65840,68176,134016,96.5736
Portugal,1952,30,58436,59474,117910,98.2547
Portugal,1952,31,65170,68832,134002,94.6798
Portugal,1952,32,44848,45956,90804,97.589
Portugal,1952,33,49546,52708,102254,94.0009
Portugal,1952,34,51034,54281,105315,94.0182
Portugal,1952,35,50310,54316,104626,92.6246
Portugal,1952,36,53588,57151,110739,93.7656
Portugal,1952,37,54019,58460,112479,92.4034
Portugal,1952,38,53277,57396,110673,92.8235
Portugal,1952,39,56972,62372,119344,91.3423
Portugal,1952,40,52145,55727,107872,93.5722
Portugal,1952,41,59399,66133,125532,89.8175
Portugal,1952,42,44061,46865,90926,94.0169
Portugal,1952,43,51708,57030,108738,90.6681
Portugal,1952,44,45911,52470,98381,87.4995
Portugal,1952,45,44764,52391,97155,85.4422
Portugal,1952,46,46161,52948,99109,87.1818
Portugal,1952,47,41441,49336,90777,83.9975
Portugal,1952,48,40472,48388,88860,83.6406
Portugal,1952,49,42560,52106,94666,81.6797
Portugal,1952,50,38031,44360,82391,85.7326
Portugal,1952,51,45757,57069,102826,80.1784
Portugal,1952,52,30741,35616,66357,86.3123
Portugal,1952,53,34786,42794,77580,81.2871
Portugal,1952,54,31500,39016,70516,80.7361
Portugal,1952,55,30527,38236,68763,79.8384
Portugal,1952,56,31441,39778,71219,79.0412
Portugal,1952,57,30299,38773,69072,78.1446
Portugal,1952,58,27739,35231,62970,78.7346
Portugal,1952,59,29318,38440,67758,76.2695
Portugal,1952,60,24668,30882,55550,79.8782
Portugal,1952,61,31688,45024,76712,70.3802
Portugal,1952,62,20785,25896,46681,80.2634
Portugal,1952,63,24908,32899,57807,75.7105
Portugal,1952,64,23084,30904,53988,74.6958
Portugal,1952,65,21610,30132,51742,71.7178
Portugal,1952,66,21335,31287,52622,68.1913
Portugal,1952,67,20554,29175,49729,70.4507
Portugal,1952,68,17674,25096,42770,70.4256
Portugal,1952,69,17612,26465,44077,66.5483
Portugal,1952,70,13882,19039,32921,72.9135
Portugal,1952,71,18683,29197,47880,63.9895
Portugal,1952,72,10740,14711,25451,73.0066
Portugal,1952,73,12903,19333,32236,66.7408
Portugal,1952,74,11503,16299,27802,70.5749
Portugal,1952,75,10159,15395,25554,65.989
Portugal,1952,76,10143,17084,27227,59.3713
Portugal,1952,77,8297,13543,21840,61.2641
Portugal,1952,78,7016,11401,18417,61.5385
Portugal,1952,79,6838,11979,18817,57.0832
Portugal,1952,80,5362,10155,15517,52.8016
Portugal,1952,81,4592,8987,13579,51.096
Portugal,1952,82,3835,7737,11572,49.567
Portugal,1952,83,3081,6556,9637,46.9951
Portugal,1952,84,2522,5647,8169,44.6609
Portugal,1952,85,1990,4664,6654,42.6672
Portugal,1952,86,1540,3831,5371,40.1984
Portugal,1952,87,1199,3160,4359,37.943
Portugal,1952,88,884,2512,3396,35.1911
Portugal,1952,89,660,1978,2638,33.367
Portugal,1952,90,521,1580,2101,32.9747
Portugal,1952,91,400,1251,1651,31.9744
Portugal,1952,92,291,986,1277,29.5132
Portugal,1952,93,205,741,946,27.6653
Portugal,1952,94,135,564,699,23.9362
Portugal,1952,95,96,414,510,23.1884
Portugal,1952,96,70,314,384,22.293
Portugal,1952,97,45,235,280,19.1489
Portugal,1952,98,27,143,170,18.8811
Portugal,1952,99,13,91,104,14.2857
Portugal,1952,100,30,183,213,16.3934
Portugal,1953,0,101547,95069,196616,106.814
Portugal,1953,1,94616,89299,183915,105.9542
Portugal,1953,2,84518,80809,165327,104.5898
Portugal,1953,3,88162,83967,172129,104.996
Portugal,1953,4,90766,87730,178496,103.4606
Portugal,1953,5,87287,84838,172125,102.8867
Portugal,1953,6,89176,86691,175867,102.8665
Portugal,1953,7,85669,83287,168956,102.86
Portugal,1953,8,83617,82189,165806,101.7375
Portugal,1953,9,82451,81065,163516,101.7097
Portugal,1953,10,75598,73647,149245,102.6491
Portugal,1953,11,71154,70085,141239,101.5253
Portugal,1953,12,75690,75080,150770,100.8125
Portugal,1953,13,75454,75053,150507,100.5343
Portugal,1953,14,81504,80454,161958,101.3051
Portugal,1953,15,77276,77488,154764,99.7264
Portugal,1953,16,81475,79866,161341,102.0146
Portugal,1953,17,77906,78631,156537,99.078
Portugal,1953,18,77278,78685,155963,98.2119
Portugal,1953,19,78480,79403,157883,98.8376
Portugal,1953,20,81672,83390,165062,97.9398
Portugal,1953,21,72801,74567,147368,97.6317
Portugal,1953,22,72200,77972,150172,92.5973
Portugal,1953,23,74503,70161,144664,106.1886
Portugal,1953,24,74601,76123,150724,98.0006
Portugal,1953,25,71252,73043,144295,97.548
Portugal,1953,26,71647,73596,145243,97.3518
Portugal,1953,27,69449,73051,142500,95.0692
Portugal,1953,28,67533,71064,138597,95.0312
Portugal,1953,29,64964,68082,133046,95.4202
Portugal,1953,30,64789,67337,132126,96.216
Portugal,1953,31,57809,59065,116874,97.8735
Portugal,1953,32,64548,68390,132938,94.3822
Portugal,1953,33,44547,45675,90222,97.5304
Portugal,1953,34,49113,52363,101476,93.7933
Portugal,1953,35,50454,53836,104290,93.718
Portugal,1953,36,49922,53958,103880,92.5201
Portugal,1953,37,53209,56798,110007,93.6811
Portugal,1953,38,53361,57754,111115,92.3936
Portugal,1953,39,52731,56846,109577,92.7611
Portugal,1953,40,56230,61725,117955,91.0976
Portugal,1953,41,51667,55283,106950,93.4591
Portugal,1953,42,58774,65732,124506,89.4146
Portugal,1953,43,43973,46824,90797,93.9112
Portugal,1953,44,50980,56349,107329,90.4719
Portugal,1953,45,45589,52127,97716,87.4576
Portugal,1953,46,44350,52021,96371,85.254
Portugal,1953,47,45576,52575,98151,86.6876
Portugal,1953,48,41173,49129,90302,83.8059
Portugal,1953,49,40174,48045,88219,83.6174
Portugal,1953,50,41872,51305,93177,81.6139
Portugal,1953,51,37612,43869,81481,85.7371
Portugal,1953,52,45087,56659,101746,79.5761
Portugal,1953,53,30360,35215,65575,86.2133
Portugal,1953,54,34191,42118,76309,81.1791
Portugal,1953,55,31104,38609,69713,80.5615
Portugal,1953,56,30118,37870,67988,79.53
Portugal,1953,57,30851,39284,70135,78.5332
Portugal,1953,58,29675,38169,67844,77.7463
Portugal,1953,59,27333,34859,62192,78.4102
Portugal,1953,60,28652,37738,66390,75.9235
Portugal,1953,61,24145,30367,54512,79.5107
Portugal,1953,62,30689,43881,74570,69.9369
Portugal,1953,63,20421,25624,46045,79.6948
Portugal,1953,64,24338,32321,56659,75.3009
Portugal,1953,65,22382,30120,52502,74.3094
Portugal,1953,66,20896,29282,50178,71.3612
Portugal,1953,67,20536,30418,50954,67.5127
Portugal,1953,68,19620,28094,47714,69.837
Portugal,1953,69,16986,24325,41311,69.8294
Portugal,1953,70,16811,25491,42302,65.9488
Portugal,1953,71,13280,18383,31663,72.2407
Portugal,1953,72,17588,27907,45495,63.0236
Portugal,1953,73,10087,14155,24242,71.261
Portugal,1953,74,12012,18354,30366,65.4462
Portugal,1953,75,10633,15411,26044,68.9962
Portugal,1953,76,9318,14510,23828,64.2178
Portugal,1953,77,9218,15955,25173,57.775
Portugal,1953,78,7442,12541,19983,59.3414
Portugal,1953,79,6280,10525,16805,59.6675
Portugal,1953,80,5476,10473,15949,52.2868
Portugal,1953,81,4682,9089,13771,51.5128
Portugal,1953,82,3988,8065,12053,49.4482
Portugal,1953,83,3277,6821,10098,48.0428
Portugal,1953,84,2579,5713,8292,45.1427
Portugal,1953,85,2039,4777,6816,42.6837
Portugal,1953,86,1583,3886,5469,40.736
Portugal,1953,87,1218,3190,4408,38.1818
Portugal,1953,88,915,2576,3491,35.5202
Portugal,1953,89,664,2014,2678,32.9692
Portugal,1953,90,490,1540,2030,31.8182
Portugal,1953,91,395,1240,1635,31.8548
Portugal,1953,92,314,1015,1329,30.936
Portugal,1953,93,209,772,981,27.0725
Portugal,1953,94,147,575,722,25.5652
Portugal,1953,95,96,412,508,23.301
Portugal,1953,96,68,277,345,24.5487
Portugal,1953,97,48,210,258,22.8571
Portugal,1953,98,24,154,178,15.5844
Portugal,1953,99,12,86,98,13.9535
Portugal,1953,100,24,167,191,14.3713
Portugal,1954,0,96605,91602,188207,105.4617
Portugal,1954,1,95908,90657,186565,105.7922
Portugal,1954,2,92228,87281,179509,105.6679
Portugal,1954,3,84196,80708,164904,104.3218
Portugal,1954,4,87584,83511,171095,104.8772
Portugal,1954,5,90511,87602,178113,103.3207
Portugal,1954,6,86434,84316,170750,102.512
Portugal,1954,7,88088,85911,173999,102.534
Portugal,1954,8,85190,83289,168479,102.2824
Portugal,1954,9,82828,81894,164722,101.1405
Portugal,1954,10,81434,80576,162010,101.0648
Portugal,1954,11,74878,73658,148536,101.6563
Portugal,1954,12,70087,69717,139804,100.5307
Portugal,1954,13,74727,74934,149661,99.7238
Portugal,1954,14,74017,74823,148840,98.9228
Portugal,1954,15,79915,79699,159614,100.271
Portugal,1954,16,76058,76917,152975,98.8832
Portugal,1954,17,79856,79101,158957,100.9545
Portugal,1954,18,76574,77953,154527,98.231
Portugal,1954,19,75641,77530,153171,97.5635
Portugal,1954,20,76744,78260,155004,98.0629
Portugal,1954,21,79760,81906,161666,97.3799
Portugal,1954,22,71431,73316,144747,97.4289
Portugal,1954,23,71425,77218,148643,92.4979
Portugal,1954,24,72569,69243,141812,104.8034
Portugal,1954,25,72878,74931,147809,97.2601
Portugal,1954,26,69749,72056,141805,96.7983
Portugal,1954,27,70203,72529,142732,96.793
Portugal,1954,28,68386,72163,140549,94.766
Portugal,1954,29,66463,70172,136635,94.7144
Portugal,1954,30,63813,67025,130838,95.2078
Portugal,1954,31,63799,66527,130326,95.8994
Portugal,1954,32,57223,58693,115916,97.4954
Portugal,1954,33,63945,67963,131908,94.088
Portugal,1954,34,44277,45416,89693,97.4921
Portugal,1954,35,48724,52020,100744,93.664
Portugal,1954,36,49906,53387,103293,93.4797
Portugal,1954,37,49558,53619,103177,92.4262
Portugal,1954,38,52855,56458,109313,93.6183
Portugal,1954,39,52742,57072,109814,92.4131
Portugal,1954,40,52215,56322,108537,92.708
Portugal,1954,41,55511,61096,116607,90.8586
Portugal,1954,42,51195,54834,106029,93.3636
Portugal,1954,43,58166,65328,123494,89.0369
Portugal,1954,44,43943,46795,90738,93.9053
Portugal,1954,45,50281,55667,105948,90.3246
Portugal,1954,46,45299,51798,97097,87.4532
Portugal,1954,47,44005,51664,95669,85.1754
Portugal,1954,48,45030,52179,97209,86.2991
Portugal,1954,49,40908,48915,89823,83.6308
Portugal,1954,50,39854,47728,87582,83.5023
Portugal,1954,51,41207,50526,91733,81.556
Portugal,1954,52,37221,43367,80588,85.8279
Portugal,1954,53,44390,56214,100604,78.9661
Portugal,1954,54,29982,34808,64790,86.1354
Portugal,1954,55,33599,41432,75031,81.0943
Portugal,1954,56,30657,38188,68845,80.2791
Portugal,1954,57,29659,37509,67168,79.0717
Portugal,1954,58,30254,38791,69045,77.9923
Portugal,1954,59,29058,37555,66613,77.3745
Portugal,1954,60,26890,34413,61303,78.1391
Portugal,1954,61,27984,37039,65023,75.5528
Portugal,1954,62,23602,29861,53463,79.0395
Portugal,1954,63,29616,42632,72248,69.4689
Portugal,1954,64,20042,25295,45337,79.2331
Portugal,1954,65,23746,31688,55434,74.9369
Portugal,1954,66,21611,29327,50938,73.6898
Portugal,1954,67,20137,28425,48562,70.8426
Portugal,1954,68,19735,29490,49225,66.921
Portugal,1954,69,18692,27046,45738,69.1119
Portugal,1954,70,16257,23480,39737,69.2376
Portugal,1954,71,16020,24501,40521,65.3851
Portugal,1954,72,12661,17761,30422,71.2854
Portugal,1954,73,16418,26486,42904,61.9875
Portugal,1954,74,9413,13542,22955,69.5097
Portugal,1954,75,11058,17246,28304,64.1192
Portugal,1954,76,9764,14473,24237,67.4636
Portugal,1954,77,8511,13631,22142,62.4386
Portugal,1954,78,8320,14698,23018,56.6063
Portugal,1954,79,6675,11534,18209,57.8724
Portugal,1954,80,5663,11081,16744,51.1055
Portugal,1954,81,4747,9379,14126,50.6131
Portugal,1954,82,4051,8123,12174,49.8707
Portugal,1954,83,3358,7091,10449,47.3558
Portugal,1954,84,2681,5931,8612,45.2032
Portugal,1954,85,2071,4835,6906,42.8335
Portugal,1954,86,1651,3972,5623,41.566
Portugal,1954,87,1254,3179,4433,39.4464
Portugal,1954,88,915,2549,3464,35.8964
Portugal,1954,89,666,2054,2720,32.4245
Portugal,1954,90,477,1579,2056,30.209
Portugal,1954,91,356,1196,1552,29.7659
Portugal,1954,92,292,991,1283,29.4652
Portugal,1954,93,219,777,996,28.1853
Portugal,1954,94,141,588,729,23.9796
Portugal,1954,95,101,424,525,23.8208
Portugal,1954,96,67,293,360,22.8669
Portugal,1954,97,46,193,239,23.8342
Portugal,1954,98,31,132,163,23.4848
Portugal,1954,99,16,89,105,17.9775
Portugal,1954,100,20,154,174,12.987
Portugal,1955,0,95308,89995,185303,105.9037
Portugal,1955,1,91994,87948,179942,104.6004
Portugal,1955,2,93884,89016,182900,105.4687
Portugal,1955,3,90982,86271,177253,105.4607
Portugal,1955,4,84315,80995,165310,104.099
Portugal,1955,5,87189,83196,170385,104.7995
Portugal,1955,6,90357,87531,177888,103.2286
Portugal,1955,7,85626,83823,169449,102.151
Portugal,1955,8,87032,85147,172179,102.2138
Portugal,1955,9,84736,83303,168039,101.7202
Portugal,1955,10,82058,81607,163665,100.5526
Portugal,1955,11,80440,80094,160534,100.432
Portugal,1955,12,74180,73667,147847,100.6964
Portugal,1955,13,69035,69345,138380,99.553
Portugal,1955,14,73761,74789,148550,98.6255
Portugal,1955,15,72564,74590,147154,97.2838
Portugal,1955,16,78314,78945,157259,99.2007
Portugal,1955,17,74830,76345,151175,98.0156
Portugal,1955,18,78227,78327,156554,99.8723
Portugal,1955,19,75238,77273,152511,97.3665
Portugal,1955,20,73998,76371,150369,96.8928
Portugal,1955,21,75010,77112,152122,97.2741
Portugal,1955,22,77849,80414,158263,96.8103
Portugal,1955,23,70069,72070,142139,97.2235
Portugal,1955,24,70667,76482,147149,92.3969
Portugal,1955,25,70644,68326,138970,103.3926
Portugal,1955,26,71149,73719,144868,96.5138
Portugal,1955,27,68227,71043,139270,96.0362
Portugal,1955,28,68734,71468,140202,96.1745
Portugal,1955,29,67297,71294,138591,94.3936
Portugal,1955,30,65372,69289,134661,94.3469
Portugal,1955,31,62652,65999,128651,94.9287
Portugal,1955,32,62802,65732,128534,95.5425
Portugal,1955,33,56617,58306,114923,97.1032
Portugal,1955,34,63324,67547,130871,93.7481
Portugal,1955,35,43987,45165,89152,97.3918
Portugal,1955,36,48306,51687,99993,93.4587
Portugal,1955,37,49340,52946,102286,93.1893
Portugal,1955,38,49174,53283,102457,92.2883
Portugal,1955,39,52471,56131,108602,93.4795
Portugal,1955,40,52089,56381,108470,92.3875
Portugal,1955,41,51692,55803,107495,92.633
Portugal,1955,42,54775,60472,115247,90.5791
Portugal,1955,43,50687,54374,105061,93.2192
Portugal,1955,44,57524,64922,122446,88.6048
Portugal,1955,45,43839,46749,90588,93.7753
Portugal,1955,46,49534,54963,104497,90.1224
Portugal,1955,47,44983,51455,96438,87.422
Portugal,1955,48,43615,51288,94903,85.0394
Portugal,1955,49,44447,51783,96230,85.8332
Portugal,1955,50,40613,48698,89311,83.3977
Portugal,1955,51,39529,47393,86922,83.4068
Portugal,1955,52,40510,49728,90238,81.4632
Portugal,1955,53,36768,42845,79613,85.8163
Portugal,1955,54,43666,55771,99437,78.2952
Portugal,1955,55,29571,34378,63949,86.0172
Portugal,1955,56,32948,40723,73671,80.9076
Portugal,1955,57,30182,37757,67939,79.9375
Portugal,1955,58,29196,37105,66301,78.6848
Portugal,1955,59,29624,38236,67860,77.4767
Portugal,1955,60,28403,36847,65250,77.0836
Portugal,1955,61,26446,33963,60409,77.8671
Portugal,1955,62,27281,36349,63630,75.053
Portugal,1955,63,22981,29290,52271,78.4602
Portugal,1955,64,28490,41367,69857,68.8713
Portugal,1955,65,19600,24909,44509,78.6864
Portugal,1955,66,23095,30972,54067,74.5674
Portugal,1955,67,20816,28446,49262,73.1772
Portugal,1955,68,19348,27476,46824,70.4178
Portugal,1955,69,18872,28528,47400,66.1526
Portugal,1955,70,17660,25857,43517,68.2987
Portugal,1955,71,15470,22548,38018,68.6092
Portugal,1955,72,15120,23460,38580,64.4501
Portugal,1955,73,11884,16986,28870,69.9635
Portugal,1955,74,15227,25044,40271,60.801
Portugal,1955,75,8703,12812,21515,67.9285
Portugal,1955,76,10053,16017,26070,62.7646
Portugal,1955,77,8854,13499,22353,65.59
Portugal,1955,78,7643,12719,20362,60.0912
Portugal,1955,79,7394,13523,20917,54.6772
Portugal,1955,80,6142,11588,17730,53.0031
Portugal,1955,81,4921,9983,14904,49.2938
Portugal,1955,82,4088,8442,12530,48.4245
Portugal,1955,83,3403,7159,10562,47.5346
Portugal,1955,84,2762,6137,8899,45.0057
Portugal,1955,85,2167,5001,7168,43.3313
Portugal,1955,86,1665,4034,5699,41.2742
Portugal,1955,87,1283,3274,4557,39.1875
Portugal,1955,88,945,2570,3515,36.7704
Portugal,1955,89,690,2025,2715,34.0741
Portugal,1955,90,493,1575,2068,31.3016
Portugal,1955,91,350,1209,1559,28.9495
Portugal,1955,92,265,947,1212,27.9831
Portugal,1955,93,204,752,956,27.1277
Portugal,1955,94,145,577,722,25.13
Portugal,1955,95,87,421,508,20.6651
Portugal,1955,96,62,285,347,21.7544
Portugal,1955,97,42,190,232,22.1053
Portugal,1955,98,24,118,142,20.339
Portugal,1955,99,12,77,89,15.5844
Portugal,1955,100,15,136,151,11.0294
Portugal,1956,0,99969,95228,195197,104.9786
Portugal,1956,1,90614,86169,176783,105.1585
Portugal,1956,2,89934,86145,176079,104.3984
Portugal,1956,3,92569,87942,180511,105.2614
Portugal,1956,4,90018,85489,175507,105.2978
Portugal,1956,5,84572,81386,165958,103.9147
Portugal,1956,6,86867,82948,169815,104.7246
Portugal,1956,7,90233,87513,177746,103.1081
Portugal,1956,8,84848,83368,168216,101.7753
Portugal,1956,9,85994,84413,170407,101.8729
Portugal,1956,10,84300,83338,167638,101.1543
Portugal,1956,11,81315,81326,162641,99.9865
Portugal,1956,12,79455,79616,159071,99.7978
Portugal,1956,13,73473,73684,147157,99.7136
Portugal,1956,14,67979,68981,136960,98.5474
Portugal,1956,15,72795,74652,147447,97.5125
Portugal,1956,16,71106,74364,145470,95.6188
Portugal,1956,17,76701,78184,154885,98.1032
Portugal,1956,18,73597,75763,149360,97.1411
Portugal,1956,19,76599,77558,154157,98.7635
Portugal,1956,20,73895,76591,150486,96.48
Portugal,1956,21,72349,75202,147551,96.2062
Portugal,1956,22,73271,75946,149217,96.4778
Portugal,1956,23,75953,78910,154863,96.2527
Portugal,1956,24,68713,70823,139536,97.0207
Portugal,1956,25,69884,75747,145631,92.2598
Portugal,1956,26,68698,67422,136120,101.8926
Portugal,1956,27,69421,72523,141944,95.7227
Portugal,1956,28,66706,70035,136741,95.2467
Portugal,1956,29,67283,70399,137682,95.5738
Portugal,1956,30,66223,70416,136639,94.0454
Portugal,1956,31,64283,68413,132696,93.9631
Portugal,1956,32,61489,64977,126466,94.6319
Portugal,1956,33,61784,64936,126720,95.146
Portugal,1956,34,55988,57919,113907,96.666
Portugal,1956,35,62695,67123,129818,93.4032
Portugal,1956,36,43697,44918,88615,97.2817
Portugal,1956,37,47876,51365,99241,93.2074
Portugal,1956,38,48751,52511,101262,92.8396
Portugal,1956,39,48780,52947,101727,92.1299
Portugal,1956,40,52079,55803,107882,93.3265
Portugal,1956,41,51422,55701,107123,92.3179
Portugal,1956,42,51122,55274,106396,92.4883
Portugal,1956,43,53983,59828,113811,90.2303
Portugal,1956,44,50141,53918,104059,92.9949
Portugal,1956,45,56856,64511,121367,88.1338
Portugal,1956,46,43732,46702,90434,93.6405
Portugal,1956,47,48753,54262,103015,89.8474
Portugal,1956,48,44620,51092,95712,87.3327
Portugal,1956,49,43170,50893,94063,84.825
Portugal,1956,50,43801,51350,95151,85.2989
Portugal,1956,51,40299,48428,88727,83.2143
Portugal,1956,52,39163,47009,86172,83.3096
Portugal,1956,53,39763,48902,88665,81.3116
Portugal,1956,54,36265,42295,78560,85.743
Portugal,1956,55,42844,55282,98126,77.5008
Portugal,1956,56,29083,33923,63006,85.7324
Portugal,1956,57,32272,39982,72254,80.7163
Portugal,1956,58,29685,37299,66984,79.5866
Portugal,1956,59,28709,36702,65411,78.2219
Portugal,1956,60,28950,37651,66601,76.8904
Portugal,1956,61,27692,36142,63834,76.62
Portugal,1956,62,25924,33491,59415,77.4059
Portugal,1956,63,26489,35578,62067,74.4533
Portugal,1956,64,22311,28682,50993,77.7875
Portugal,1956,65,27347,40031,67378,68.3146
Portugal,1956,66,19115,24457,43572,78.1576
Portugal,1956,67,22358,30227,52585,73.967
Portugal,1956,68,19923,27528,47451,72.3736
Portugal,1956,69,18487,26492,44979,69.7833
Portugal,1956,70,17963,27441,45404,65.4604
Portugal,1956,71,16626,24625,41251,67.5168
Portugal,1956,72,14658,21639,36297,67.7388
Portugal,1956,73,14166,22320,36486,63.4677
Portugal,1956,74,11119,16160,27279,68.8057
Portugal,1956,75,14005,23482,37487,59.6414
Portugal,1956,76,7991,12008,19999,66.5473
Portugal,1956,77,9051,14797,23848,61.1678
Portugal,1956,78,7881,12445,20326,63.3266
Portugal,1956,79,6774,11724,18498,57.7789
Portugal,1956,80,6413,11882,18295,53.9724
Portugal,1956,81,5344,10408,15752,51.3451
Portugal,1956,82,4223,8910,13133,47.3962
Portugal,1956,83,3443,7391,10834,46.5837
Portugal,1956,84,2807,6211,9018,45.194
Portugal,1956,85,2215,5181,7396,42.7524
Portugal,1956,86,1713,4146,5859,41.3169
Portugal,1956,87,1299,3325,4624,39.0677
Portugal,1956,88,972,2643,3615,36.7764
Portugal,1956,89,704,2055,2759,34.2579
Portugal,1956,90,512,1575,2087,32.5079
Portugal,1956,91,356,1197,1553,29.741
Portugal,1956,92,255,937,1192,27.2145
Portugal,1956,93,189,714,903,26.4706
Portugal,1956,94,138,564,702,24.4681
Portugal,1956,95,95,418,513,22.7273
Portugal,1956,96,58,296,354,19.5946
Portugal,1956,97,44,192,236,22.9167
Portugal,1956,98,29,111,140,26.1261
Portugal,1956,99,16,65,81,24.6154
Portugal,1956,100,16,123,139,13.0081
Portugal,1957,0,96855,92820,189675,104.3471
Portugal,1957,1,94725,90711,185436,104.425
Portugal,1957,2,88877,84780,173657,104.8325
Portugal,1957,3,88685,85163,173848,104.1356
Portugal,1957,4,91596,87175,178771,105.0714
Portugal,1957,5,89163,84802,173965,105.1426
Portugal,1957,6,84860,81827,166687,103.7066
Portugal,1957,7,86561,82731,169292,104.6295
Portugal,1957,8,90124,87524,177648,102.9706
Portugal,1957,9,84080,82937,167017,101.3782
Portugal,1957,10,84974,83700,168674,101.5221
Portugal,1957,11,83870,83387,167257,100.5792
Portugal,1957,12,80567,81054,161621,99.3992
Portugal,1957,13,78469,79139,157608,99.1534
Portugal,1957,14,72769,73694,146463,98.7448
Portugal,1957,15,66925,68609,135534,97.5455
Portugal,1957,16,71828,74511,146339,96.3992
Portugal,1957,17,69651,74132,143783,93.9554
Portugal,1957,18,75096,77416,152512,97.0032
Portugal,1957,19,72359,75179,147538,96.249
Portugal,1957,20,74973,76784,151757,97.6414
Portugal,1957,21,72562,75916,148478,95.582
Portugal,1957,22,70693,74040,144733,95.4795
Portugal,1957,23,71525,74795,146320,95.6281
Portugal,1957,24,74055,77425,151480,95.6474
Portugal,1957,25,67370,69587,136957,96.8141
Portugal,1957,26,69129,75018,144147,92.1499
Portugal,1957,27,66764,66519,133283,100.3683
Portugal,1957,28,67688,71345,139033,94.8742
Portugal,1957,29,65175,69040,134215,94.4018
Portugal,1957,30,65808,69323,135131,94.9295
Portugal,1957,31,65142,69541,134683,93.6742
Portugal,1957,32,63186,67528,130714,93.5701
Portugal,1957,33,60289,63933,124222,94.3003
Portugal,1957,34,60750,64121,124871,94.7428
Portugal,1957,35,55363,57515,112878,96.2584
Portugal,1957,36,62050,66687,128737,93.0466
Portugal,1957,37,43399,44655,88054,97.1873
Portugal,1957,38,47443,51020,98463,92.989
Portugal,1957,39,48147,52065,100212,92.4748
Portugal,1957,40,48353,52594,100947,91.9363
Portugal,1957,41,51659,55453,107112,93.1582
Portugal,1957,42,50728,54990,105718,92.2495
Portugal,1957,43,50532,54723,105255,92.3414
Portugal,1957,44,53179,59188,112367,89.8476
Portugal,1957,45,49573,53443,103016,92.7586
Portugal,1957,46,56176,64076,120252,87.6709
Portugal,1957,47,43599,46628,90227,93.5039
Portugal,1957,48,47932,53528,101460,89.5457
Portugal,1957,49,44208,50708,94916,87.1815
Portugal,1957,50,42672,50469,93141,84.5509
Portugal,1957,51,43122,50903,94025,84.7141
Portugal,1957,52,39928,48135,88063,82.95
Portugal,1957,53,38720,46573,85293,83.1383
Portugal,1957,54,38938,48025,86963,81.0786
Portugal,1957,55,35661,41698,77359,85.5221
Portugal,1957,56,41974,54731,96705,76.6915
Portugal,1957,57,28546,33394,61940,85.4824
Portugal,1957,58,31485,39166,70651,80.3886
Portugal,1957,59,29110,36769,65879,79.17
Portugal,1957,60,28123,36217,64340,77.6514
Portugal,1957,61,28168,36991,65159,76.1483
Portugal,1957,62,26904,35373,62277,76.058
Portugal,1957,63,25287,32892,58179,76.8789
Portugal,1957,64,25592,34680,60272,73.7947
Portugal,1957,65,21532,27956,49488,77.021
Portugal,1957,66,26057,38592,64649,67.5192
Portugal,1957,67,18534,23919,42453,77.4865
Portugal,1957,68,21536,29354,50890,73.3665
Portugal,1957,69,18903,26487,45390,71.3671
Portugal,1957,70,17470,25296,42766,69.0623
Portugal,1957,71,16923,26160,43083,64.6904
Portugal,1957,72,15450,23248,38698,66.4573
Portugal,1957,73,13619,20459,34078,66.5673
Portugal,1957,74,13032,20953,33985,62.1963
Portugal,1957,75,10145,15039,25184,67.4579
Portugal,1957,76,12636,21646,34282,58.3757
Portugal,1957,77,7157,11057,18214,64.7282
Portugal,1957,78,7886,13389,21275,58.8991
Portugal,1957,79,6869,11241,18110,61.1067
Portugal,1957,80,6315,11810,18125,53.4716
Portugal,1957,81,5440,10385,15825,52.3832
Portugal,1957,82,4480,9076,13556,49.361
Portugal,1957,83,3404,7636,11040,44.5783
Portugal,1957,84,2713,6248,8961,43.4219
Portugal,1957,85,2153,5102,7255,42.1991
Portugal,1957,86,1667,4195,5862,39.7378
Portugal,1957,87,1279,3313,4592,38.6055
Portugal,1957,88,955,2567,3522,37.203
Portugal,1957,89,696,1995,2691,34.8872
Portugal,1957,90,481,1510,1991,31.8543
Portugal,1957,91,345,1132,1477,30.477
Portugal,1957,92,244,863,1107,28.2735
Portugal,1957,93,161,650,811,24.7692
Portugal,1957,94,114,492,606,23.1707
Portugal,1957,95,87,364,451,23.9011
Portugal,1957,96,59,253,312,23.3202
Portugal,1957,97,32,176,208,18.1818
Portugal,1957,98,24,99,123,24.2424
Portugal,1957,99,14,52,66,26.9231
Portugal,1957,100,13,98,111,13.2653
Portugal,1958,0,100983,96042,197025,105.1446
Portugal,1958,1,92165,88716,180881,103.8877
Portugal,1958,2,92143,88256,180399,104.4042
Portugal,1958,3,87778,83929,171707,104.586
Portugal,1958,4,87685,84400,172085,103.8922
Portugal,1958,5,90707,86511,177218,104.8503
Portugal,1958,6,88365,84179,172544,104.9727
Portugal,1958,7,85172,82307,167479,103.4809
Portugal,1958,8,86268,82540,168808,104.5166
Portugal,1958,9,90047,87541,177588,102.8627
Portugal,1958,10,83337,82505,165842,101.0084
Portugal,1958,11,83953,82983,166936,101.1689
Portugal,1958,12,83438,83432,166870,100.0072
Portugal,1958,13,79819,80774,160593,98.8177
Portugal,1958,14,77475,78660,156135,98.4935
Portugal,1958,15,72059,73701,145760,97.7721
Portugal,1958,16,65857,68230,134087,96.5221
Portugal,1958,17,70841,74368,145209,95.2574
Portugal,1958,18,68175,73889,142064,92.2668
Portugal,1958,19,73481,76631,150112,95.8894
Portugal,1958,20,71112,74591,145703,95.3359
Portugal,1958,21,73334,76011,149345,96.4781
Portugal,1958,22,71215,75239,146454,94.6517
Portugal,1958,23,69037,72881,141918,94.7256
Portugal,1958,24,69767,73633,143400,94.7496
Portugal,1958,25,72124,75917,148041,95.0038
Portugal,1958,26,65992,68340,134332,96.5642
Portugal,1958,27,68359,74287,142646,92.0201
Portugal,1958,28,64825,65604,130429,98.8126
Portugal,1958,29,65952,70156,136108,94.0076
Portugal,1958,30,63667,68048,131715,93.5619
Portugal,1958,31,64356,68267,132623,94.271
Portugal,1958,32,64074,68680,132754,93.2935
Portugal,1958,33,62100,66631,128731,93.1999
Portugal,1958,34,59109,62873,121982,94.0133
Portugal,1958,35,59721,63308,123029,94.334
Portugal,1958,36,54733,57129,111862,95.806
Portugal,1958,37,61410,66251,127661,92.6929
Portugal,1958,38,43096,44389,87485,97.0871
Portugal,1958,39,47013,50688,97701,92.7498
Portugal,1958,40,47541,51613,99154,92.1105
Portugal,1958,41,47933,52246,100179,91.7448
Portugal,1958,42,51256,55118,106374,92.9932
Portugal,1958,43,50049,54278,104327,92.2086
Portugal,1958,44,49962,54160,104122,92.2489
Portugal,1958,45,52364,58520,110884,89.4805
Portugal,1958,46,49004,52956,101960,92.5372
Portugal,1958,47,55492,63636,119128,87.2022
Portugal,1958,48,43451,46550,90001,93.3426
Portugal,1958,49,47126,52794,99920,89.2639
Portugal,1958,50,43787,50324,94111,87.0102
Portugal,1958,51,42172,50064,92236,84.2362
Portugal,1958,52,42420,50469,92889,84.0516
Portugal,1958,53,39511,47861,87372,82.5536
Portugal,1958,54,38286,46180,84466,82.906
Portugal,1958,55,38108,47161,85269,80.8041
Portugal,1958,56,35046,41079,76125,85.3137
Portugal,1958,57,41101,54175,95276,75.8671
Portugal,1958,58,28025,32883,60908,85.2264
Portugal,1958,59,30737,38399,69136,80.0464
Portugal,1958,60,28506,36252,64758,78.6329
Portugal,1958,61,27536,35754,63290,77.0152
Portugal,1958,62,27437,36375,63812,75.4282
Portugal,1958,63,26113,34600,60713,75.4711
Portugal,1958,64,24665,32314,56979,76.3291
Portugal,1958,65,24732,33791,58523,73.1911
Portugal,1958,66,20792,27196,47988,76.4524
Portugal,1958,67,24810,37117,61927,66.8427
Portugal,1958,68,17939,23335,41274,76.8759
Portugal,1958,69,20712,28483,49195,72.7171
Portugal,1958,70,17887,25402,43289,70.4157
Portugal,1958,71,16490,24127,40617,68.3467
Portugal,1958,72,15927,24963,40890,63.8024
Portugal,1958,73,14281,21824,36105,65.4371
Portugal,1958,74,12679,19293,31972,65.7181
Portugal,1958,75,12011,19596,31607,61.2931
Portugal,1958,76,9305,14038,23343,66.2844
Portugal,1958,77,11365,20003,31368,56.8165
Portugal,1958,78,6430,10195,16625,63.0701
Portugal,1958,79,6959,12114,19073,57.4459
Portugal,1958,80,6435,12064,18499,53.3405
Portugal,1958,81,5457,10591,16048,51.5249
Portugal,1958,82,4632,9268,13900,49.9784
Portugal,1958,83,3746,7943,11689,47.161
Portugal,1958,84,2823,6588,9411,42.8506
Portugal,1958,85,2185,5270,7455,41.4611
Portugal,1958,86,1700,4231,5931,40.1796
Portugal,1958,87,1302,3432,4734,37.9371
Portugal,1958,88,959,2652,3611,36.1614
Portugal,1958,89,704,2022,2726,34.817
Portugal,1958,90,511,1542,2053,33.1388
Portugal,1958,91,345,1153,1498,29.9219
Portugal,1958,92,242,865,1107,27.9769
Portugal,1958,93,167,633,800,26.3823
Portugal,1958,94,107,471,578,22.7176
Portugal,1958,95,73,343,416,21.2828
Portugal,1958,96,58,245,303,23.6735
Portugal,1958,97,42,162,204,25.9259
Portugal,1958,98,19,100,119,19
Portugal,1958,99,11,55,66,20
Portugal,1958,100,15,84,99,17.8571
Portugal,1959,0,101423,96987,198410,104.5738
Portugal,1959,1,95811,91573,187384,104.628
Portugal,1959,2,90584,87095,177679,104.006
Portugal,1959,3,90543,86746,177289,104.3771
Portugal,1959,4,87098,83483,170581,104.3302
Portugal,1959,5,86888,83795,170683,103.6912
Portugal,1959,6,89910,85932,175842,104.6292
Portugal,1959,7,87619,83604,171223,104.8024
Portugal,1959,8,85544,82822,168366,103.2866
Portugal,1959,9,86020,82384,168404,104.4135
Portugal,1959,10,89982,87587,177569,102.7344
Portugal,1959,11,82591,82089,164680,100.6115
Portugal,1959,12,82951,82283,165234,100.8118
Portugal,1959,13,83021,83483,166504,99.4466
Portugal,1959,14,79064,80504,159568,98.2113
Portugal,1959,15,76477,78194,154671,97.8042
Portugal,1959,16,71348,73721,145069,96.7811
Portugal,1959,17,64797,67867,132664,95.4764
Portugal,1959,18,69865,74232,144097,94.1171
Portugal,1959,19,66711,73656,140367,90.571
Portugal,1959,20,71857,75868,147725,94.7132
Portugal,1959,21,69872,74025,143897,94.3897
Portugal,1959,22,71715,75256,146971,95.2947
Portugal,1959,23,69884,74572,144456,93.7135
Portugal,1959,24,67408,71737,139145,93.9655
Portugal,1959,25,68045,72492,140537,93.8655
Portugal,1959,26,70238,74434,144672,94.3628
Portugal,1959,27,64665,67106,131771,96.3625
Portugal,1959,28,67628,73551,141179,91.9471
Portugal,1959,29,62929,64699,127628,97.2643
Portugal,1959,30,64259,68973,133232,93.1654
Portugal,1959,31,62166,67050,129216,92.7159
Portugal,1959,32,62904,67202,130106,93.6044
Portugal,1959,33,63008,67827,130835,92.8952
Portugal,1959,34,61020,65766,126786,92.7835
Portugal,1959,35,57928,61851,119779,93.6573
Portugal,1959,36,58693,62524,121217,93.8728
Portugal,1959,37,54125,56755,110880,95.366
Portugal,1959,38,60804,65828,126632,92.368
Portugal,1959,39,42805,44120,86925,97.0195
Portugal,1959,40,46575,50347,96922,92.508
Portugal,1959,41,46951,51178,98129,91.7406
Portugal,1959,42,47519,51913,99432,91.5358
Portugal,1959,43,50844,54798,105642,92.7844
Portugal,1959,44,49360,53602,102962,92.0861
Portugal,1959,45,49384,53633,103017,92.0776
Portugal,1959,46,51581,57892,109473,89.0987
Portugal,1959,47,48447,52495,100942,92.2888
Portugal,1959,48,54812,63210,118022,86.7141
Portugal,1959,49,43316,46506,89822,93.1407
Portugal,1959,50,46335,52086,98421,88.9586
Portugal,1959,51,43424,49953,93377,86.9297
Portugal,1959,52,41720,49664,91384,84.0045
Portugal,1959,53,41753,50047,91800,83.4276
Portugal,1959,54,39140,47615,86755,82.201
Portugal,1959,55,37898,45797,83695,82.7521
Portugal,1959,56,37353,46292,83645,80.69
Portugal,1959,57,34514,40483,74997,85.2555
Portugal,1959,58,40268,53659,93927,75.0443
Portugal,1959,59,27489,32388,59877,84.874
Portugal,1959,60,29991,37601,67592,79.7612
Portugal,1959,61,27968,35744,63712,78.2453
Portugal,1959,62,26970,35298,62268,76.4066
Portugal,1959,63,26667,35719,62386,74.6577
Portugal,1959,64,25352,33801,59153,75.0037
Portugal,1959,65,24097,31735,55832,75.9319
Portugal,1959,66,23884,32926,56810,72.5384
Portugal,1959,67,20063,26467,46530,75.8038
Portugal,1959,68,23591,35707,59298,66.0683
Portugal,1959,69,17412,22856,40268,76.1813
Portugal,1959,70,19940,27663,47603,72.0818
Portugal,1959,71,16948,24409,41357,69.4334
Portugal,1959,72,15589,23062,38651,67.596
Portugal,1959,73,14980,23808,38788,62.92
Portugal,1959,74,13219,20516,33735,64.4326
Portugal,1959,75,11842,18193,30035,65.091
Portugal,1959,76,11120,18312,29432,60.7252
Portugal,1959,77,8588,13157,21745,65.2732
Portugal,1959,78,10177,18399,28576,55.3128
Portugal,1959,79,5821,9442,15263,61.6501
Portugal,1959,80,6571,12306,18877,53.3967
Portugal,1959,81,5687,10915,16602,52.1026
Portugal,1959,82,4763,9564,14327,49.8013
Portugal,1959,83,3954,8217,12171,48.1198
Portugal,1959,84,3144,6968,10112,45.1206
Portugal,1959,85,2316,5676,7992,40.8034
Portugal,1959,86,1762,4466,6228,39.4536
Portugal,1959,87,1359,3537,4896,38.4224
Portugal,1959,88,1029,2823,3852,36.4506
Portugal,1959,89,739,2132,2871,34.6623
Portugal,1959,90,530,1588,2118,33.3753
Portugal,1959,91,376,1196,1572,31.4381
Portugal,1959,92,255,893,1148,28.5554
Portugal,1959,93,167,654,821,25.5352
Portugal,1959,94,108,468,576,23.0769
Portugal,1959,95,73,339,412,21.5339
Portugal,1959,96,52,238,290,21.8487
Portugal,1959,97,36,157,193,22.9299
Portugal,1959,98,22,96,118,22.9167
Portugal,1959,99,8,64,72,12.5
Portugal,1959,100,12,86,98,13.9535
Portugal,1960,0,99641,94438,194079,105.5094
Portugal,1960,1,95821,92003,187824,104.1499
Portugal,1960,2,93324,89151,182475,104.6808
Portugal,1960,3,89599,86011,175610,104.1716
Portugal,1960,4,89148,85424,174572,104.3594
Portugal,1960,5,86508,83141,169649,104.0497
Portugal,1960,6,86136,83246,169382,103.4716
Portugal,1960,7,89136,85378,174514,104.4016
Portugal,1960,8,86874,83050,169924,104.6045
Portugal,1960,9,85911,83349,169260,103.0738
Portugal,1960,10,85772,82234,168006,104.3024
Portugal,1960,11,89917,87637,177554,102.6016
Portugal,1960,12,81851,81681,163532,100.2081
Portugal,1960,13,81943,81582,163525,100.4425
Portugal,1960,14,82591,83530,166121,98.8759
Portugal,1960,15,78305,80230,158535,97.6006
Portugal,1960,16,75482,77726,153208,97.1129
Portugal,1960,17,70635,73739,144374,95.7906
Portugal,1960,18,63720,67502,131222,94.3972
Portugal,1960,19,68871,74094,142965,92.9508
Portugal,1960,20,65231,73422,138653,88.8439
Portugal,1960,21,70238,75111,145349,93.5123
Portugal,1960,22,68628,73459,142087,93.4235
Portugal,1960,23,70070,74496,144566,94.0587
Portugal,1960,24,68536,73901,142437,92.7403
Portugal,1960,25,65760,70587,136347,93.1616
Portugal,1960,26,66299,71350,137649,92.9208
Portugal,1960,27,68340,72946,141286,93.6857
Portugal,1960,28,63320,65874,129194,96.1229
Portugal,1960,29,66869,72831,139700,91.8139
Portugal,1960,30,60997,63798,124795,95.6096
Portugal,1960,31,62526,67796,130322,92.2267
Portugal,1960,32,60655,66060,126715,91.818
Portugal,1960,33,61449,66139,127588,92.9089
Portugal,1960,34,61939,66964,128903,92.496
Portugal,1960,35,59951,64877,124828,92.4072
Portugal,1960,36,56745,60811,117556,93.3137
Portugal,1960,37,57648,61717,119365,93.407
Portugal,1960,38,53500,56357,109857,94.9305
Portugal,1960,39,60163,65402,125565,91.9895
Portugal,1960,40,42493,43867,86360,96.8678
Portugal,1960,41,46145,50017,96162,92.2586
Portugal,1960,42,46362,50747,97109,91.3591
Portugal,1960,43,47112,51575,98687,91.3466
Portugal,1960,44,50448,54453,104901,92.645
Portugal,1960,45,48674,52906,101580,92.0009
Portugal,1960,46,48779,53111,101890,91.8435
Portugal,1960,47,50771,57266,108037,88.6582
Portugal,1960,48,47885,52031,99916,92.0317
Portugal,1960,49,54127,62795,116922,86.1964
Portugal,1960,50,43172,46439,89611,92.965
Portugal,1960,51,45524,51369,96893,88.6215
Portugal,1960,52,43027,49586,92613,86.7725
Portugal,1960,53,41230,49217,90447,83.7719
Portugal,1960,54,41051,49593,90644,82.7758
Portugal,1960,55,38741,47349,86090,81.8201
Portugal,1960,56,37482,45379,82861,82.5977
Portugal,1960,57,36538,45421,81959,80.443
Portugal,1960,58,33922,39899,73821,85.0197
Portugal,1960,59,39411,53139,92550,74.1659
Portugal,1960,60,26921,31873,58794,84.4633
Portugal,1960,61,29181,36806,65987,79.2833
Portugal,1960,62,27358,35208,62566,77.7039
Portugal,1960,63,26333,34791,61124,75.6891
Portugal,1960,64,25853,35057,60910,73.7456
Portugal,1960,65,24520,32980,57500,74.3481
Portugal,1960,66,23443,31120,54563,75.331
Portugal,1960,67,22983,32027,55010,71.7613
Portugal,1960,68,19245,25690,44935,74.9124
Portugal,1960,69,22284,34223,56507,65.1141
Portugal,1960,70,16803,22252,39055,75.5123
Portugal,1960,71,19104,26762,45866,71.3848
Portugal,1960,72,15963,23331,39294,68.4197
Portugal,1960,73,14572,21828,36400,66.7583
Portugal,1960,74,13914,22486,36400,61.8785
Portugal,1960,75,12048,19016,31064,63.3572
Portugal,1960,76,10904,16950,27854,64.3304
Portugal,1960,77,10119,16946,27065,59.7132
Portugal,1960,78,7802,12152,19954,64.2034
Portugal,1960,79,8997,16759,25756,53.6846
Portugal,1960,80,6730,12549,19279,53.6298
Portugal,1960,81,5760,11085,16845,51.9621
Portugal,1960,82,4899,9731,14630,50.3443
Portugal,1960,83,4013,8378,12391,47.8993
Portugal,1960,84,3300,7127,10427,46.3028
Portugal,1960,85,2551,5919,8470,43.0985
Portugal,1960,86,1841,4715,6556,39.0456
Portugal,1960,87,1387,3661,5048,37.8858
Portugal,1960,88,1030,2859,3889,36.0266
Portugal,1960,89,757,2250,3007,33.6444
Portugal,1960,90,531,1656,2187,32.0652
Portugal,1960,91,377,1204,1581,31.3123
Portugal,1960,92,259,896,1155,28.9062
Portugal,1960,93,162,637,799,25.4317
Portugal,1960,94,104,448,552,23.2143
Portugal,1960,95,68,323,391,21.0526
Portugal,1960,96,41,229,270,17.9039
Portugal,1960,97,28,150,178,18.6667
Portugal,1960,98,19,94,113,20.2128
Portugal,1960,99,12,55,67,21.8182
Portugal,1960,100,13,86,99,15.1163
Portugal,1961,0,96998,90850,187848,106.7672
Portugal,1961,1,90803,86130,176933,105.4255
Portugal,1961,2,93587,89779,183366,104.2415
Portugal,1961,3,91743,87569,179312,104.7665
Portugal,1961,4,88911,85228,174139,104.3213
Portugal,1961,5,87892,84245,172137,104.329
Portugal,1961,6,85948,82837,168785,103.7556
Portugal,1961,7,85369,82730,168099,103.1899
Portugal,1961,8,88349,84864,173213,104.1066
Portugal,1961,9,86104,82492,168596,104.3786
Portugal,1961,10,86205,83827,170032,102.8368
Portugal,1961,11,85430,82024,167454,104.1524
Portugal,1961,12,89738,87610,177348,102.4289
Portugal,1961,13,81039,81202,162241,99.7993
Portugal,1961,14,80874,80812,161686,100.0767
Portugal,1961,15,82066,83486,165552,98.2991
Portugal,1961,16,77456,79867,157323,96.9812
Portugal,1961,17,74402,77176,151578,96.4056
Portugal,1961,18,69841,73680,143521,94.7896
Portugal,1961,19,62610,67077,129687,93.3405
Portugal,1961,20,67861,73899,141760,91.8294
Portugal,1961,21,63751,73111,136862,87.1975
Portugal,1961,22,68618,74307,142925,92.3439
Portugal,1961,23,67373,72841,140214,92.4932
Portugal,1961,24,68422,73698,142120,92.8411
Portugal,1961,25,67187,73213,140400,91.7692
Portugal,1961,26,64129,69433,133562,92.361
Portugal,1961,27,64594,70200,134794,92.0142
Portugal,1961,28,66486,71486,137972,93.0056
Portugal,1961,29,61996,64662,126658,95.877
Portugal,1961,30,66139,72122,138261,91.7043
Portugal,1961,31,59121,62898,122019,93.995
Portugal,1961,32,60854,66643,127497,91.3134
Portugal,1961,33,59176,65063,124239,90.9518
Portugal,1961,34,60025,65091,125116,92.217
Portugal,1961,35,60875,66122,126997,92.0647
Portugal,1961,36,58859,64001,122860,91.9658
Portugal,1961,37,55586,59792,115378,92.9656
Portugal,1961,38,56624,60919,117543,92.9497
Portugal,1961,39,52866,55947,108813,94.493
Portugal,1961,40,59539,64976,124515,91.6323
Portugal,1961,41,42171,43609,85780,96.7025
Portugal,1961,42,45693,49697,95390,91.9432
Portugal,1961,43,45761,50308,96069,90.9617
Portugal,1961,44,46680,51222,97902,91.1327
Portugal,1961,45,50023,54095,104118,92.4725
Portugal,1961,46,47977,52211,100188,91.8906
Portugal,1961,47,48181,52564,100745,91.6616
Portugal,1961,48,49951,56625,106576,88.2137
Portugal,1961,49,47271,51546,98817,91.7064
Portugal,1961,50,53414,62339,115753,85.6831
Portugal,1961,51,42989,46313,89302,92.8227
Portugal,1961,52,44699,50619,95318,88.3048
Portugal,1961,53,42571,49164,91735,86.5898
Portugal,1961,54,40715,48765,89480,83.4923
Portugal,1961,55,40355,49150,89505,82.1058
Portugal,1961,56,38290,47056,85346,81.3711
Portugal,1961,57,36981,44910,81891,82.3447
Portugal,1961,58,35675,44519,80194,80.1343
Portugal,1961,59,33284,39303,72587,84.6856
Portugal,1961,60,38507,52580,91087,73.2351
Portugal,1961,61,26320,31328,57648,84.0143
Portugal,1961,62,28365,36006,64371,78.7785
Portugal,1961,63,26696,34605,61301,77.1449
Portugal,1961,64,25647,34202,59849,74.9868
Portugal,1961,65,25008,34335,59343,72.8353
Portugal,1961,66,23624,32120,55744,73.5492
Portugal,1961,67,22717,30417,53134,74.6852
Portugal,1961,68,22033,31022,53055,71.0238
Portugal,1961,69,18432,24817,43249,74.2717
Portugal,1961,70,20963,32639,53602,64.2268
Portugal,1961,71,16091,21554,37645,74.6544
Portugal,1961,72,18201,25721,43922,70.7632
Portugal,1961,73,14877,22102,36979,67.3107
Portugal,1961,74,13519,20572,34091,65.7155
Portugal,1961,75,12868,21149,34017,60.8445
Portugal,1961,76,10881,17532,28413,62.0637
Portugal,1961,77,9956,15699,25655,63.4181
Portugal,1961,78,9127,15475,24602,58.979
Portugal,1961,79,7028,11053,18081,63.5845
Portugal,1961,80,6987,12907,19894,54.1334
Portugal,1961,81,5834,11237,17071,51.9178
Portugal,1961,82,4942,9851,14793,50.1675
Portugal,1961,83,4117,8550,12667,48.152
Portugal,1961,84,3321,7233,10554,45.9146
Portugal,1961,85,2663,6002,8665,44.3685
Portugal,1961,86,2011,4919,6930,40.8823
Portugal,1961,87,1429,3856,5285,37.0591
Portugal,1961,88,1053,2930,3983,35.9386
Portugal,1961,89,753,2250,3003,33.4667
Portugal,1961,90,548,1731,2279,31.658
Portugal,1961,91,386,1240,1626,31.129
Portugal,1961,92,267,887,1154,30.1015
Portugal,1961,93,175,655,830,26.7176
Portugal,1961,94,103,461,564,22.3427
Portugal,1961,95,68,310,378,21.9355
Portugal,1961,96,47,220,267,21.3636
Portugal,1961,97,27,161,188,16.7702
Portugal,1961,98,17,100,117,17
Portugal,1961,99,12,59,71,20.339
Portugal,1961,100,12,83,95,14.4578
Portugal,1962,0,103620,98753,202373,104.9285
Portugal,1962,1,92370,87193,179563,105.9374
Portugal,1962,2,88897,84314,173211,105.4356
Portugal,1962,3,92174,88672,180846,103.9494
Portugal,1962,4,90305,86472,176777,104.4326
Portugal,1962,5,87709,84415,172124,103.9022
Portugal,1962,6,86571,83424,169995,103.7723
Portugal,1962,7,84656,82083,166739,103.1346
Portugal,1962,8,83862,81876,165738,102.4256
Portugal,1962,9,86771,84309,171080,102.9202
Portugal,1962,10,83872,81151,165023,103.353
Portugal,1962,11,84419,82899,167318,101.8336
Portugal,1962,12,82932,80443,163375,103.0941
Portugal,1962,13,86897,85812,172709,101.2644
Portugal,1962,14,78330,79211,157541,98.8878
Portugal,1962,15,78244,78573,156817,99.5813
Portugal,1962,16,79311,81368,160679,97.472
Portugal,1962,17,74610,77529,152139,96.235
Portugal,1962,18,71873,74950,146823,95.8946
Portugal,1962,19,67534,71854,139388,93.9878
Portugal,1962,20,60548,65166,125714,92.9135
Portugal,1962,21,66372,72447,138819,91.6146
Portugal,1962,22,61971,70989,132960,87.2966
Portugal,1962,23,66776,72528,139304,92.0693
Portugal,1962,24,65659,71243,136902,92.162
Portugal,1962,25,66607,72126,138733,92.3481
Portugal,1962,26,66025,72089,138114,91.5882
Portugal,1962,27,62779,68133,130912,92.1418
Portugal,1962,28,63262,68924,132186,91.7852
Portugal,1962,29,65334,70532,135866,92.6303
Portugal,1962,30,60871,63715,124586,95.5364
Portugal,1962,31,65475,71564,137039,91.4915
Portugal,1962,32,57985,61760,119745,93.8876
Portugal,1962,33,60168,65914,126082,91.2826
Portugal,1962,34,58213,64111,122324,90.8003
Portugal,1962,35,59158,64352,123510,91.9288
Portugal,1962,36,60199,65507,125706,91.897
Portugal,1962,37,57831,63068,120899,91.6963
Portugal,1962,38,54800,59044,113844,92.8121
Portugal,1962,39,55849,60347,116196,92.5464
Portugal,1962,40,52220,55279,107499,94.4663
Portugal,1962,41,59198,64682,123880,91.5216
Portugal,1962,42,41649,43201,84850,96.4075
Portugal,1962,43,45142,49250,94392,91.6589
Portugal,1962,44,45244,49791,95035,90.8678
Portugal,1962,45,46029,50640,96669,90.8945
Portugal,1962,46,49541,53574,103115,92.4721
Portugal,1962,47,47470,51828,99298,91.5914
Portugal,1962,48,47571,51868,99439,91.7155
Portugal,1962,49,49300,55944,105244,88.1238
Portugal,1962,50,46561,50854,97415,91.5582
Portugal,1962,51,53029,62058,115087,85.4507
Portugal,1962,52,42289,45640,87929,92.6578
Portugal,1962,53,44003,50058,94061,87.904
Portugal,1962,54,41971,48657,90628,86.2589
Portugal,1962,55,40089,48237,88326,83.1084
Portugal,1962,56,39936,48855,88791,81.7439
Portugal,1962,57,37577,46468,84045,80.8664
Portugal,1962,58,36257,44284,80541,81.8738
Portugal,1962,59,35012,43871,78883,79.8067
Portugal,1962,60,32480,38548,71028,84.2586
Portugal,1962,61,37756,51837,89593,72.836
Portugal,1962,62,25613,30739,56352,83.3241
Portugal,1962,63,27619,35384,63003,78.0551
Portugal,1962,64,25871,33792,59663,76.5595
Portugal,1962,65,24804,33376,58180,74.3169
Portugal,1962,66,24225,33506,57731,72.3005
Portugal,1962,67,22682,31143,53825,72.8318
Portugal,1962,68,21837,29542,51379,73.9185
Portugal,1962,69,21149,30109,51258,70.2415
Portugal,1962,70,17543,23993,41536,73.1172
Portugal,1962,71,19906,31545,51451,63.1035
Portugal,1962,72,15206,20753,35959,73.2713
Portugal,1962,73,17092,24436,41528,69.946
Portugal,1962,74,13872,20948,34820,66.2211
Portugal,1962,75,12486,19482,31968,64.0899
Portugal,1962,76,11773,19838,31611,59.3457
Portugal,1962,77,9900,16382,26282,60.4322
Portugal,1962,78,8970,14510,23480,61.8194
Portugal,1962,79,8145,14203,22348,57.347
Portugal,1962,80,7125,13189,20314,54.0223
Portugal,1962,81,6081,11625,17706,52.3097
Portugal,1962,82,5035,10031,15066,50.1944
Portugal,1962,83,4218,8661,12879,48.7011
Portugal,1962,84,3446,7430,10876,46.3795
Portugal,1962,85,2722,6158,8880,44.2027
Portugal,1962,86,2151,5044,7195,42.6447
Portugal,1962,87,1597,4096,5693,38.9893
Portugal,1962,88,1093,3137,4230,34.8422
Portugal,1962,89,789,2314,3103,34.0968
Portugal,1962,90,564,1746,2310,32.3024
Portugal,1962,91,405,1336,1741,30.3144
Portugal,1962,92,271,939,1210,28.8605
Portugal,1962,93,181,656,837,27.5915
Portugal,1962,94,118,483,601,24.4306
Portugal,1962,95,67,332,399,20.1807
Portugal,1962,96,37,216,253,17.1296
Portugal,1962,97,25,143,168,17.4825
Portugal,1962,98,17,104,121,16.3462
Portugal,1962,99,10,66,76,15.1515
Portugal,1962,100,12,87,99,13.7931
Portugal,1963,0,106149,100160,206309,105.9794
Portugal,1963,1,98462,94388,192850,104.3162
Portugal,1963,2,91081,86245,177326,105.6073
Portugal,1963,3,87858,83282,171140,105.4946
Portugal,1963,4,91088,87812,178900,103.7307
Portugal,1963,5,88981,85486,174467,104.0884
Portugal,1963,6,86561,83679,170240,103.4441
Portugal,1963,7,85275,82648,167923,103.1785
Portugal,1963,8,83376,81351,164727,102.4892
Portugal,1963,9,82358,81043,163401,101.6226
Portugal,1963,10,85202,83764,168966,101.7167
Portugal,1963,11,81657,79814,161471,102.3091
Portugal,1963,12,82640,81974,164614,100.8125
Portugal,1963,13,80447,78863,159310,102.0085
Portugal,1963,14,84060,84020,168080,100.0476
Portugal,1963,15,75615,77222,152837,97.919
Portugal,1963,16,75624,76338,151962,99.0647
Portugal,1963,17,76562,79258,155820,96.5985
Portugal,1963,18,71760,75194,146954,95.4331
Portugal,1963,19,69343,72730,142073,95.343
Portugal,1963,20,65226,70040,135266,93.1268
Portugal,1963,21,58494,63255,121749,92.4733
Portugal,1963,22,64897,70998,135895,91.4068
Portugal,1963,23,60200,68869,129069,87.4123
Portugal,1963,24,64931,70741,135672,91.7869
Portugal,1963,25,63954,69651,133605,91.8206
Portugal,1963,26,64785,70554,135339,91.8233
Portugal,1963,27,64827,70953,135780,91.3661
Portugal,1963,28,61403,66823,128226,91.889
Portugal,1963,29,61927,67629,129556,91.5687
Portugal,1963,30,64186,69566,133752,92.2663
Portugal,1963,31,59743,62775,122518,95.1701
Portugal,1963,32,64792,71003,135795,91.2525
Portugal,1963,33,56840,60620,117460,93.7644
Portugal,1963,34,59491,65187,124678,91.2621
Portugal,1963,35,57261,63149,120410,90.676
Portugal,1963,36,58302,63606,121908,91.6612
Portugal,1963,37,59518,64890,124408,91.7214
Portugal,1963,38,56788,62150,118938,91.3725
Portugal,1963,39,54013,58320,112333,92.6149
Portugal,1963,40,55057,59781,114838,92.0978
Portugal,1963,41,51549,54622,106171,94.3741
Portugal,1963,42,58832,64400,123232,91.354
Portugal,1963,43,41109,42786,83895,96.0805
Portugal,1963,44,44558,48793,93351,91.3205
Portugal,1963,45,44693,49278,93971,90.6956
Portugal,1963,46,45355,50058,95413,90.6049
Portugal,1963,47,49010,53063,102073,92.3619
Portugal,1963,48,46896,51432,98328,91.1806
Portugal,1963,49,46919,51136,98055,91.7534
Portugal,1963,50,48623,55249,103872,88.007
Portugal,1963,51,45829,50161,95990,91.3638
Portugal,1963,52,52619,61770,114389,85.1854
Portugal,1963,53,41550,44956,86506,92.4237
Portugal,1963,54,43268,49486,92754,87.4348
Portugal,1963,55,41331,48139,89470,85.8576
Portugal,1963,56,39432,47687,87119,82.6892
Portugal,1963,57,39506,48504,88010,81.449
Portugal,1963,58,36883,45843,82726,80.455
Portugal,1963,59,35518,43642,79160,81.3849
Portugal,1963,60,34291,43199,77490,79.3792
Portugal,1963,61,31659,37778,69437,83.8027
Portugal,1963,62,36955,51097,88052,72.3232
Portugal,1963,63,24807,30123,54930,82.3524
Portugal,1963,64,26817,34695,61512,77.2936
Portugal,1963,65,24994,32924,57918,75.9142
Portugal,1963,66,23913,32505,56418,73.5671
Portugal,1963,67,23399,32602,56001,71.7717
Portugal,1963,68,21666,30076,51742,72.0375
Portugal,1963,69,20892,28624,49516,72.9877
Portugal,1963,70,20204,29117,49321,69.389
Portugal,1963,71,16622,23056,39678,72.094
Portugal,1963,72,18822,30364,49186,61.9879
Portugal,1963,73,14263,19851,34114,71.8503
Portugal,1963,74,15937,23090,39027,69.0212
Portugal,1963,75,12831,19733,32564,65.0231
Portugal,1963,76,11452,18341,29793,62.4393
Portugal,1963,77,10735,18475,29210,58.1055
Portugal,1963,78,8957,15177,24134,59.0169
Portugal,1963,79,7980,13351,21331,59.7708
Portugal,1963,80,7230,13326,20556,54.2548
Portugal,1963,81,6202,11950,18152,51.8996
Portugal,1963,82,5199,10435,15634,49.8227
Portugal,1963,83,4242,8852,13094,47.9214
Portugal,1963,84,3507,7519,11026,46.6418
Portugal,1963,85,2810,6330,9140,44.3918
Portugal,1963,86,2178,5167,7345,42.1521
Portugal,1963,87,1706,4188,5894,40.7354
Portugal,1963,88,1251,3356,4607,37.2765
Portugal,1963,89,840,2475,3315,33.9394
Portugal,1963,90,587,1790,2377,32.7933
Portugal,1963,91,407,1361,1768,29.9045
Portugal,1963,92,287,1025,1312,28
Portugal,1963,93,187,716,903,26.1173
Portugal,1963,94,123,488,611,25.2049
Portugal,1963,95,79,337,416,23.4421
Portugal,1963,96,40,226,266,17.6991
Portugal,1963,97,22,149,171,14.7651
Portugal,1963,98,17,91,108,18.6813
Portugal,1963,99,10,64,74,15.625
Portugal,1963,100,11,92,103,11.9565
Portugal,1964,0,102430,96925,199355,105.6796
Portugal,1964,1,101336,96102,197438,105.4463
Portugal,1964,2,96079,92141,188220,104.2739
Portugal,1964,3,90377,85852,176229,105.2707
Portugal,1964,4,87018,82476,169494,105.5071
Portugal,1964,5,90081,87052,177133,103.4795
Portugal,1964,6,87700,84561,172261,103.7121
Portugal,1964,7,85430,82947,168377,102.9935
Portugal,1964,8,84004,81868,165872,102.6091
Portugal,1964,9,82131,80633,162764,101.8578
Portugal,1964,10,80886,80219,161105,100.8315
Portugal,1964,11,83650,83225,166875,100.5107
Portugal,1964,12,79438,78482,157920,101.2181
Portugal,1964,13,80852,81051,161903,99.7545
Portugal,1964,14,77953,77281,155234,100.8696
Portugal,1964,15,81211,82228,163439,98.7632
Portugal,1964,16,72886,75228,148114,96.8868
Portugal,1964,17,72988,74096,147084,98.5046
Portugal,1964,18,73798,77149,150947,95.6565
Portugal,1964,19,68903,72864,141767,94.5638
Portugal,1964,20,66809,70514,137323,94.7457
Portugal,1964,21,62924,68224,131148,92.2315
Portugal,1964,22,56447,61345,117792,92.0156
Portugal,1964,23,63430,69547,132977,91.2045
Portugal,1964,24,58434,66751,125185,87.5403
Portugal,1964,25,63096,68963,132059,91.4925
Portugal,1964,26,62253,68060,130313,91.4678
Portugal,1964,27,62980,68978,131958,91.3045
Portugal,1964,28,63650,69833,133483,91.146
Portugal,1964,29,60034,65529,125563,91.6144
Portugal,1964,30,60596,66351,126947,91.3264
Portugal,1964,31,63020,68624,131644,91.8338
Portugal,1964,32,58590,61840,120430,94.7445
Portugal,1964,33,64122,70451,134573,91.0165
Portugal,1964,34,55714,59485,115199,93.6606
Portugal,1964,35,58804,64452,123256,91.2369
Portugal,1964,36,56296,62193,118489,90.5182
Portugal,1964,37,57437,62877,120314,91.3482
Portugal,1964,38,58838,64300,123138,91.5054
Portugal,1964,39,55750,61237,116987,91.0397
Portugal,1964,40,53222,57569,110791,92.4491
Portugal,1964,41,54265,59199,113464,91.6654
Portugal,1964,42,50873,53961,104834,94.2773
Portugal,1964,43,58445,64120,122565,91.1494
Portugal,1964,44,40553,42383,82936,95.6822
Portugal,1964,45,43987,48347,92334,90.9819
Portugal,1964,46,44127,48742,92869,90.5318
Portugal,1964,47,44659,49445,94104,90.3206
Portugal,1964,48,48499,52518,101017,92.3474
Portugal,1964,49,46331,51024,97355,90.8024
Portugal,1964,50,46237,50400,96637,91.7401
Portugal,1964,51,47901,54522,102423,87.8563
Portugal,1964,52,45059,49417,94476,91.1812
Portugal,1964,53,52171,61432,113603,84.9248
Portugal,1964,54,40780,44246,85026,92.1665
Portugal,1964,55,42511,48910,91421,86.9168
Portugal,1964,56,40649,47587,88236,85.4204
Portugal,1964,57,38696,47092,85788,82.1711
Portugal,1964,58,38989,48142,87131,80.9875
Portugal,1964,59,36097,45188,81285,79.8818
Portugal,1964,60,34699,42962,77661,80.7667
Portugal,1964,61,33532,42497,76029,78.9044
Portugal,1964,62,30766,36954,67720,83.2549
Portugal,1964,63,36097,50311,86408,71.7477
Portugal,1964,64,24022,29479,53501,81.4885
Portugal,1964,65,25999,33978,59977,76.5172
Portugal,1964,66,24054,32025,56079,75.1101
Portugal,1964,67,22930,31601,54531,72.561
Portugal,1964,68,22473,31668,54141,70.9644
Portugal,1964,69,20577,28977,49554,71.0115
Portugal,1964,70,19814,27591,47405,71.8133
Portugal,1964,71,19112,28029,47141,68.1865
Portugal,1964,72,15574,22043,37617,70.6528
Portugal,1964,73,17598,29031,46629,60.618
Portugal,1964,74,13199,18832,32031,70.0881
Portugal,1964,75,14667,21633,36300,67.7992
Portugal,1964,76,11701,18370,30071,63.6962
Portugal,1964,77,10405,17074,27479,60.9406
Portugal,1964,78,9640,17016,26656,56.6526
Portugal,1964,79,7948,13901,21849,57.1757
Portugal,1964,80,7214,13679,20893,52.7378
Portugal,1964,81,6219,11988,18207,51.8769
Portugal,1964,82,5280,10618,15898,49.7269
Portugal,1964,83,4367,9119,13486,47.889
Portugal,1964,84,3510,7638,11148,45.9544
Portugal,1964,85,2831,6371,9202,44.4357
Portugal,1964,86,2237,5218,7455,42.8708
Portugal,1964,87,1698,4202,5900,40.4093
Portugal,1964,88,1304,3365,4669,38.7519
Portugal,1964,89,930,2640,3570,35.2273
Portugal,1964,90,603,1932,2535,31.2112
Portugal,1964,91,407,1373,1780,29.6431
Portugal,1964,92,273,1032,1305,26.4535
Portugal,1964,93,183,760,943,24.0789
Portugal,1964,94,110,510,620,21.5686
Portugal,1964,95,75,342,417,21.9298
Portugal,1964,96,50,226,276,22.1239
Portugal,1964,97,23,137,160,16.7883
Portugal,1964,98,13,86,99,15.1163
Portugal,1964,99,10,54,64,18.5185
Portugal,1964,100,10,88,98,11.3636
Portugal,1965,0,105174,98858,204032,106.389
Portugal,1965,1,97593,92916,190509,105.0336
Portugal,1965,2,98886,93918,192804,105.2897
Portugal,1965,3,94158,90351,184509,104.2136
Portugal,1965,4,89854,85591,175445,104.9807
Portugal,1965,5,86276,81705,167981,105.5945
Portugal,1965,6,89133,86313,175446,103.2672
Portugal,1965,7,86446,83636,170082,103.3598
Portugal,1965,8,84318,82234,166552,102.5342
Portugal,1965,9,82742,81112,163854,102.0096
Portugal,1965,10,80890,79925,160815,101.2074
Portugal,1965,11,79411,79392,158803,100.0239
Portugal,1965,12,82090,82682,164772,99.284
Portugal,1965,13,77224,77150,154374,100.0959
Portugal,1965,14,79069,80127,159196,98.6796
Portugal,1965,15,75446,75694,151140,99.6724
Portugal,1965,16,78329,80422,158751,97.3975
Portugal,1965,17,70138,73232,143370,95.7751
Portugal,1965,18,70347,71864,142211,97.8891
Portugal,1965,19,71025,75042,146067,94.647
Portugal,1965,20,66040,70530,136570,93.6339
Portugal,1965,21,64282,68287,132569,94.135
Portugal,1965,22,60624,66402,127026,91.2985
Portugal,1965,23,54398,59443,113841,91.5129
Portugal,1965,24,61956,68096,130052,90.9833
Portugal,1965,25,56657,64630,121287,87.6636
Portugal,1965,26,61240,67187,128427,91.1486
Portugal,1965,27,60524,66471,126995,91.0532
Portugal,1965,28,61142,67414,128556,90.6963
Portugal,1965,29,62456,68711,131167,90.8967
Portugal,1965,30,58686,64228,122914,91.3714
Portugal,1965,31,59292,65073,124365,91.1161
Portugal,1965,32,61877,67679,129556,91.4272
Portugal,1965,33,57450,60902,118352,94.3319
Portugal,1965,34,63453,69883,133336,90.7989
Portugal,1965,35,54588,58332,112920,93.5816
Portugal,1965,36,58112,63714,121826,91.2076
Portugal,1965,37,55322,61237,116559,90.3408
Portugal,1965,38,56542,62136,118678,90.9972
Portugal,1965,39,58135,63674,121809,91.301
Portugal,1965,40,54708,60290,114998,90.7414
Portugal,1965,41,52399,56824,109223,92.2128
Portugal,1965,42,53441,58610,112051,91.1807
Portugal,1965,43,50160,53275,103435,94.153
Portugal,1965,44,58011,63822,121833,90.895
Portugal,1965,45,39967,41955,81922,95.2616
Portugal,1965,46,43393,47881,91274,90.6268
Portugal,1965,47,43561,48219,91780,90.3399
Portugal,1965,48,43936,48834,92770,89.9701
Portugal,1965,49,47926,51952,99878,92.2505
Portugal,1965,50,45736,50606,96342,90.3766
Portugal,1965,51,45530,49651,95181,91.7001
Portugal,1965,52,47136,53761,100897,87.6769
Portugal,1965,53,44244,48649,92893,90.9453
Portugal,1965,54,51671,61092,112763,84.579
Portugal,1965,55,39964,43518,83482,91.8333
Portugal,1965,56,41698,48308,90006,86.317
Portugal,1965,57,39896,47034,86930,84.8237
Portugal,1965,58,37896,46466,84362,81.5564
Portugal,1965,59,38429,47742,86171,80.4931
Portugal,1965,60,35278,44488,79766,79.2978
Portugal,1965,61,33874,42205,76079,80.2606
Portugal,1965,62,32754,41749,74503,78.4546
Portugal,1965,63,29837,36093,65930,82.667
Portugal,1965,64,35203,49466,84669,71.1661
Portugal,1965,65,23161,28772,51933,80.4984
Portugal,1965,66,25112,33205,58317,75.6272
Portugal,1965,67,23105,31054,54159,74.4027
Portugal,1965,68,21958,30605,52563,71.7464
Portugal,1965,69,21561,30647,52208,70.3527
Portugal,1965,70,19467,27780,47247,70.0756
Portugal,1965,71,18760,26531,45291,70.7097
Portugal,1965,72,18089,26907,44996,67.2279
Portugal,1965,73,14523,20919,35442,69.4249
Portugal,1965,74,16369,27653,44022,59.1943
Portugal,1965,75,12124,17774,29898,68.212
Portugal,1965,76,13425,20141,33566,66.6551
Portugal,1965,77,10590,17010,27600,62.2575
Portugal,1965,78,9325,15800,25125,59.019
Portugal,1965,79,8582,15570,24152,55.1188
Portugal,1965,80,7431,14035,21466,52.9462
Portugal,1965,81,6272,12327,18599,50.8802
Portugal,1965,82,5345,10666,16011,50.1125
Portugal,1965,83,4494,9329,13823,48.1724
Portugal,1965,84,3677,7936,11613,46.3332
Portugal,1965,85,2883,6532,9415,44.1366
Portugal,1965,86,2273,5328,7601,42.6614
Portugal,1965,87,1778,4313,6091,41.2242
Portugal,1965,88,1311,3396,4707,38.6042
Portugal,1965,89,997,2653,3650,37.5801
Portugal,1965,90,689,2076,2765,33.1888
Portugal,1965,91,426,1517,1943,28.0817
Portugal,1965,92,294,1058,1352,27.7883
Portugal,1965,93,190,766,956,24.8042
Portugal,1965,94,123,546,669,22.5275
Portugal,1965,95,75,356,431,21.0674
Portugal,1965,96,48,234,282,20.5128
Portugal,1965,97,32,151,183,21.1921
Portugal,1965,98,16,89,105,17.9775
Portugal,1965,99,10,57,67,17.5439
Portugal,1965,100,14,90,104,15.5556
Portugal,1966,0,101903,96443,198346,105.6614
Portugal,1966,1,100003,94800,194803,105.4884
Portugal,1966,2,95085,90739,185824,104.7896
Portugal,1966,3,96991,92234,189225,105.1575
Portugal,1966,4,92458,88754,181212,104.1733
Portugal,1966,5,89433,85439,174872,104.6747
Portugal,1966,6,85579,81009,166588,105.6413
Portugal,1966,7,88206,85621,173827,103.0191
Portugal,1966,8,85234,82753,167987,102.9981
Portugal,1966,9,83239,81551,164790,102.0699
Portugal,1966,10,81512,80379,161891,101.4096
Portugal,1966,11,79674,79229,158903,100.5617
Portugal,1966,12,77946,78581,156527,99.1919
Portugal,1966,13,80533,82150,162683,98.0316
Portugal,1966,14,75008,75824,150832,98.9238
Portugal,1966,15,77282,79201,156483,97.5771
Portugal,1966,16,72935,74105,147040,98.4212
Portugal,1966,17,75461,78631,154092,95.9685
Portugal,1966,18,67410,71245,138655,94.6172
Portugal,1966,19,67711,69629,137340,97.2454
Portugal,1966,20,68254,72932,141186,93.5858
Portugal,1966,21,63174,68206,131380,92.6223
Portugal,1966,22,61751,66076,127827,93.4545
Portugal,1966,23,58330,64587,122917,90.3123
Portugal,1966,24,52347,57544,109891,90.9687
Portugal,1966,25,60487,66660,127147,90.7396
Portugal,1966,26,54892,62513,117405,87.8089
Portugal,1966,27,59399,65411,124810,90.8089
Portugal,1966,28,58817,64885,123702,90.6481
Portugal,1966,29,59325,65837,125162,90.1089
Portugal,1966,30,61278,67585,128863,90.668
Portugal,1966,31,57340,62929,120269,91.1186
Portugal,1966,32,57973,63786,121759,90.8867
Portugal,1966,33,60708,66726,127434,90.981
Portugal,1966,34,56307,59961,116268,93.906
Portugal,1966,35,62777,69332,132109,90.5455
Portugal,1966,36,53433,57194,110627,93.4241
Portugal,1966,37,57414,62979,120393,91.1637
Portugal,1966,38,54348,60279,114627,90.1608
Portugal,1966,39,55650,61383,117033,90.6603
Portugal,1966,40,57437,63051,120488,91.0961
Portugal,1966,41,53665,59355,113020,90.4136
Portugal,1966,42,51582,56068,107650,91.999
Portugal,1966,43,52601,58011,110612,90.6742
Portugal,1966,44,49425,52598,102023,93.9675
Portugal,1966,45,57578,63523,121101,90.6412
Portugal,1966,46,39376,41532,80908,94.8088
Portugal,1966,47,42781,47414,90195,90.2286
Portugal,1966,48,42970,47654,90624,90.1708
Portugal,1966,49,43186,48193,91379,89.6105
Portugal,1966,50,47329,51391,98720,92.0959
Portugal,1966,51,45104,50197,95301,89.854
Portugal,1966,52,44797,48915,93712,91.5813
Portugal,1966,53,46335,53016,99351,87.3981
Portugal,1966,54,43394,47885,91279,90.6213
Portugal,1966,55,51156,60748,111904,84.2102
Portugal,1966,56,39111,42782,81893,91.4193
Portugal,1966,57,40853,47674,88527,85.6924
Portugal,1966,58,39128,46432,85560,84.2695
Portugal,1966,59,37050,45821,82871,80.8581
Portugal,1966,60,37808,47323,85131,79.8935
Portugal,1966,61,34416,43781,78197,78.6094
Portugal,1966,62,32973,41478,74451,79.4952
Portugal,1966,63,31903,40978,72881,77.854
Portugal,1966,64,28844,35193,64037,81.9595
Portugal,1966,65,34246,48565,82811,70.5158
Portugal,1966,66,22252,27991,50243,79.497
Portugal,1966,67,24172,32392,56564,74.6234
Portugal,1966,68,22070,30006,52076,73.552
Portugal,1966,69,20917,29563,50480,70.754
Portugal,1966,70,20589,29599,50188,69.5598
Portugal,1966,71,18309,26502,44811,69.0854
Portugal,1966,72,17642,25356,42998,69.5772
Portugal,1966,73,16993,25655,42648,66.2366
Portugal,1966,74,13444,19700,33144,68.2437
Portugal,1966,75,15134,26188,41322,57.7898
Portugal,1966,76,11066,16639,27705,66.5064
Portugal,1966,77,12153,18594,30747,65.3598
Portugal,1966,78,9466,15621,25087,60.5979
Portugal,1966,79,8270,14532,22802,56.9089
Portugal,1966,80,7692,14425,22117,53.3241
Portugal,1966,81,6478,12638,19116,51.2581
Portugal,1966,82,5406,11009,16415,49.1053
Portugal,1966,83,4535,9374,13909,48.3785
Portugal,1966,84,3726,8093,11819,46.0398
Portugal,1966,85,2976,6777,9753,43.9132
Portugal,1966,86,2305,5477,7782,42.0851
Portugal,1966,87,1792,4391,6183,40.8107
Portugal,1966,88,1377,3512,4889,39.2084
Portugal,1966,89,994,2732,3726,36.3836
Portugal,1966,90,732,2093,2825,34.9737
Portugal,1966,91,486,1607,2093,30.2427
Portugal,1966,92,296,1141,1437,25.9422
Portugal,1966,93,202,785,987,25.7325
Portugal,1966,94,127,571,698,22.2417
Portugal,1966,95,77,388,465,19.8454
Portugal,1966,96,48,245,293,19.5918
Portugal,1966,97,32,165,197,19.3939
Portugal,1966,98,20,111,131,18.018
Portugal,1966,99,9,65,74,13.8462
Portugal,1966,100,12,84,96,14.2857
Portugal,1967,0,100341,94393,194734,106.3013
Portugal,1967,1,97014,92529,189543,104.8471
Portugal,1967,2,96906,92291,189197,105.0005
Portugal,1967,3,92959,88937,181896,104.5223
Portugal,1967,4,95249,90687,185936,105.0305
Portugal,1967,5,90845,87213,178058,104.1645
Portugal,1967,6,89055,85312,174367,104.3874
Portugal,1967,7,84904,80338,165242,105.6835
Portugal,1967,8,87300,84956,172256,102.7591
Portugal,1967,9,84034,81888,165922,102.6207
Portugal,1967,10,82176,80881,163057,101.6011
Portugal,1967,11,80282,79641,159923,100.8049
Portugal,1967,12,78447,78529,156976,99.8956
Portugal,1967,13,76480,77773,154253,98.3375
Portugal,1967,14,78970,81616,160586,96.758
Portugal,1967,15,72776,74493,147269,97.6951
Portugal,1967,16,75485,78281,153766,96.4283
Portugal,1967,17,70417,72528,142945,97.0894
Portugal,1967,18,72574,76843,149417,94.4445
Portugal,1967,19,64661,69264,133925,93.3544
Portugal,1967,20,65063,67391,132454,96.5455
Portugal,1967,21,65492,70807,136299,92.4937
Portugal,1967,22,60322,65871,126193,91.576
Portugal,1967,23,59226,63858,123084,92.7464
Portugal,1967,24,56025,62765,118790,89.2615
Portugal,1967,25,50290,55629,105919,90.4025
Portugal,1967,26,59010,65209,124219,90.4936
Portugal,1967,27,53118,60403,113521,87.9393
Portugal,1967,28,57555,63635,121190,90.4455
Portugal,1967,29,57097,63296,120393,90.2063
Portugal,1967,30,57497,64268,121765,89.4644
Portugal,1967,31,60101,66463,126564,90.4278
Portugal,1967,32,55981,61642,117623,90.8163
Portugal,1967,33,56620,62517,119137,90.5674
Portugal,1967,34,59537,65785,125322,90.5024
Portugal,1967,35,55171,59021,114192,93.4769
Portugal,1967,36,62097,68765,130862,90.3032
Portugal,1967,37,52279,56044,108323,93.2821
Portugal,1967,38,56676,62232,118908,91.0721
Portugal,1967,39,53335,59304,112639,89.9349
Portugal,1967,40,54739,60622,115361,90.2956
Portugal,1967,41,56707,62422,119129,90.8446
Portugal,1967,42,52588,58405,110993,90.0402
Portugal,1967,43,50728,55307,106035,91.7208
Portugal,1967,44,51740,57415,109155,90.1158
Portugal,1967,45,48688,51894,100582,93.822
Portugal,1967,46,57130,63197,120327,90.3999
Portugal,1967,47,38766,41097,79863,94.3281
Portugal,1967,48,42139,46922,89061,89.8065
Portugal,1967,49,42327,47079,89406,89.9063
Portugal,1967,50,42364,47531,89895,89.1292
Portugal,1967,51,46684,50776,97460,91.9411
Portugal,1967,52,44441,49718,94159,89.3861
Portugal,1967,53,43979,48103,92082,91.4267
Portugal,1967,54,45448,52217,97665,87.0368
Portugal,1967,55,42445,47070,89515,90.1742
Portugal,1967,56,50524,60357,110881,83.7086
Portugal,1967,57,38158,42022,80180,90.8048
Portugal,1967,58,39896,47017,86913,84.8544
Portugal,1967,59,38236,45774,84010,83.5321
Portugal,1967,60,36101,45108,81209,80.0324
Portugal,1967,61,37109,46834,83943,79.2352
Portugal,1967,62,33440,42989,76429,77.7873
Portugal,1967,63,31943,40632,72575,78.6154
Portugal,1967,64,30925,40102,71027,77.1159
Portugal,1967,65,27735,34201,61936,81.0941
Portugal,1967,66,33196,47577,80773,69.7732
Portugal,1967,67,21212,27138,48350,78.1635
Portugal,1967,68,23102,31475,54577,73.3979
Portugal,1967,69,20963,28870,49833,72.6117
Portugal,1967,70,19784,28405,48189,69.6497
Portugal,1967,71,19528,28416,47944,68.7218
Portugal,1967,72,17071,25112,42183,67.9795
Portugal,1967,73,16415,23999,40414,68.3987
Portugal,1967,74,15807,24209,40016,65.2939
Portugal,1967,75,12258,18310,30568,66.947
Portugal,1967,76,13817,24592,38409,56.1849
Portugal,1967,77,9949,15398,25347,64.6123
Portugal,1967,78,10795,16903,27698,63.8644
Portugal,1967,79,8300,14104,22404,58.8486
Portugal,1967,80,7778,14904,22682,52.1873
Portugal,1967,81,6661,12970,19631,51.357
Portugal,1967,82,5493,11239,16732,48.8745
Portugal,1967,83,4504,9620,14124,46.8191
Portugal,1967,84,3741,8065,11806,46.3856
Portugal,1967,85,3021,6854,9875,44.0765
Portugal,1967,86,2391,5660,8051,42.2438
Portugal,1967,87,1812,4475,6287,40.4916
Portugal,1967,88,1350,3523,4873,38.3196
Portugal,1967,89,1022,2760,3782,37.029
Portugal,1967,90,721,2100,2821,34.3333
Portugal,1967,91,512,1615,2127,31.7028
Portugal,1967,92,334,1223,1557,27.3099
Portugal,1967,93,201,845,1046,23.787
Portugal,1967,94,132,573,705,23.0366
Portugal,1967,95,83,397,480,20.9068
Portugal,1967,96,49,256,305,19.1406
Portugal,1967,97,30,153,183,19.6078
Portugal,1967,98,19,99,118,19.1919
Portugal,1967,99,9,68,77,13.2353
Portugal,1967,100,10,86,96,11.6279
Portugal,1968,0,97219,92678,189897,104.8998
Portugal,1968,1,95276,90536,185812,105.2355
Portugal,1968,2,94248,90232,184480,104.4507
Portugal,1968,3,94205,90159,184364,104.4876
Portugal,1968,4,90962,87253,178215,104.2509
Portugal,1968,5,93564,89196,182760,104.8971
Portugal,1968,6,89247,85713,174960,104.1231
Portugal,1968,7,88678,85224,173902,104.0528
Portugal,1968,8,84233,79687,163920,105.7048
Portugal,1968,9,86407,84302,170709,102.497
Portugal,1968,10,82845,81032,163877,102.2374
Portugal,1968,11,81107,80213,161320,101.1145
Portugal,1968,12,79051,78910,157961,100.1787
Portugal,1968,13,77229,77831,155060,99.2265
Portugal,1968,14,75018,76958,151976,97.4791
Portugal,1968,15,77407,81082,158489,95.4676
Portugal,1968,16,70532,73162,143694,96.4052
Portugal,1968,17,73673,77355,151028,95.2401
Portugal,1968,18,67897,70940,138837,95.7105
Portugal,1968,19,69691,75039,144730,92.873
Portugal,1968,20,61914,67270,129184,92.0381
Portugal,1968,21,62419,65153,127572,95.8037
Portugal,1968,22,62726,68691,131417,91.3162
Portugal,1968,23,57469,63533,121002,90.4554
Portugal,1968,24,56698,61641,118339,91.981
Portugal,1968,25,53711,60958,114669,88.1115
Portugal,1968,26,48234,53723,101957,89.7828
Portugal,1968,27,57532,63760,121292,90.2321
Portugal,1968,28,51333,58283,109616,88.0754
Portugal,1968,29,55703,61856,117559,90.0527
Portugal,1968,30,55367,61707,117074,89.7256
Portugal,1968,31,55648,62688,118336,88.7698
Portugal,1968,32,58893,65342,124235,90.1304
Portugal,1968,33,54595,60355,114950,90.4565
Portugal,1968,34,55268,61237,116505,90.2526
Portugal,1968,35,58367,64825,123192,90.0378
Portugal,1968,36,54017,58062,112079,93.0333
Portugal,1968,37,61413,68192,129605,90.059
Portugal,1968,38,51126,54889,106015,93.1443
Portugal,1968,39,55941,61469,117410,91.0068
Portugal,1968,40,52320,58322,110642,89.7089
Portugal,1968,41,53806,59867,113673,89.8759
Portugal,1968,42,55939,61802,117741,90.5133
Portugal,1968,43,51471,57460,108931,89.5771
Portugal,1968,44,49866,54543,104409,91.4251
Portugal,1968,45,50873,56814,107687,89.5431
Portugal,1968,46,47927,51195,99122,93.6166
Portugal,1968,47,56662,62862,119524,90.1371
Portugal,1968,48,38122,40623,78745,93.8434
Portugal,1968,49,41465,46395,87860,89.3739
Portugal,1968,50,41669,46483,88152,89.6435
Portugal,1968,51,41563,46879,88442,88.6602
Portugal,1968,52,46025,50180,96205,91.7198
Portugal,1968,53,43729,49251,92980,88.788
Portugal,1968,54,43143,47315,90458,91.1825
Portugal,1968,55,44534,51421,95955,86.6066
Portugal,1968,56,41490,46221,87711,89.7644
Portugal,1968,57,49918,59945,109863,83.273
Portugal,1968,58,37226,41226,78452,90.2974
Portugal,1968,59,38930,46330,85260,84.0276
Portugal,1968,60,37343,45127,82470,82.7509
Portugal,1968,61,35180,44394,79574,79.2449
Portugal,1968,62,36420,46315,82735,78.6354
Portugal,1968,63,32451,42136,74587,77.0149
Portugal,1968,64,30886,39756,70642,77.6889
Portugal,1968,65,29968,39226,69194,76.3983
Portugal,1968,66,26635,33185,59820,80.2622
Portugal,1968,67,32108,46525,78633,69.0124
Portugal,1968,68,20176,26210,46386,76.9783
Portugal,1968,69,22057,30498,52555,72.3228
Portugal,1968,70,19816,27673,47489,71.6077
Portugal,1968,71,18625,27235,45860,68.3863
Portugal,1968,72,18445,27215,45660,67.7751
Portugal,1968,73,15798,23664,39462,66.7596
Portugal,1968,74,15201,22665,37866,67.0682
Portugal,1968,75,14621,22829,37450,64.0457
Portugal,1968,76,11119,16919,28038,65.719
Portugal,1968,77,12587,22975,35562,54.7856
Portugal,1968,78,8908,14172,23080,62.8563
Portugal,1968,79,9576,15259,24835,62.7564
Portugal,1968,80,8196,15369,23565,53.3281
Portugal,1968,81,6753,13451,20204,50.2044
Portugal,1968,82,5723,11636,17359,49.1836
Portugal,1968,83,4630,9921,14551,46.6687
Portugal,1968,84,3731,8324,12055,44.8222
Portugal,1968,85,3075,6892,9967,44.6169
Portugal,1968,86,2438,5795,8233,42.0708
Portugal,1968,87,1906,4695,6601,40.5964
Portugal,1968,88,1424,3626,5050,39.2719
Portugal,1968,89,1018,2765,3783,36.8174
Portugal,1968,90,754,2113,2867,35.6839
Portugal,1968,91,519,1583,2102,32.7858
Portugal,1968,92,352,1192,1544,29.5302
Portugal,1968,93,224,907,1131,24.6968
Portugal,1968,94,135,619,754,21.8094
Portugal,1968,95,89,401,490,22.1945
Portugal,1968,96,52,271,323,19.1882
Portugal,1968,97,31,166,197,18.6747
Portugal,1968,98,19,90,109,21.1111
Portugal,1968,99,12,58,70,20.6897
Portugal,1968,100,9,90,99,10
Portugal,1969,0,94099,88492,182591,106.3362
Portugal,1969,1,91446,87712,179158,104.2571
Portugal,1969,2,91982,87987,179969,104.5404
Portugal,1969,3,91765,88187,179952,104.0573
Portugal,1969,4,91608,88116,179724,103.963
Portugal,1969,5,89020,85608,174628,103.9856
Portugal,1969,6,91928,87741,179669,104.772
Portugal,1969,7,87689,84238,171927,104.0967
Portugal,1969,8,88333,85139,173472,103.7515
Portugal,1969,9,83589,79042,162631,105.7526
Portugal,1969,10,85530,83656,169186,102.2401
Portugal,1969,11,81664,80176,161840,101.8559
Portugal,1969,12,80051,79546,159597,100.6349
Portugal,1969,13,77825,78177,156002,99.5497
Portugal,1969,14,76002,77142,153144,98.5222
Portugal,1969,15,73546,76155,149701,96.5741
Portugal,1969,16,75829,80549,156378,94.1402
Portugal,1969,17,68278,71827,140105,95.059
Portugal,1969,18,71857,76430,148287,94.0167
Portugal,1969,19,65375,69360,134735,94.2546
Portugal,1969,20,66798,73244,140042,91.1993
Portugal,1969,21,59158,65276,124434,90.6275
Portugal,1969,22,59780,62912,122692,95.0216
Portugal,1969,23,59972,66584,126556,90.0697
Portugal,1969,24,54615,61212,115827,89.2227
Portugal,1969,25,54172,59432,113604,91.1495
Portugal,1969,26,51410,59142,110552,86.9264
Portugal,1969,27,46176,51817,97993,89.1136
Portugal,1969,28,56049,62323,118372,89.9331
Portugal,1969,29,49538,56173,105711,88.1883
Portugal,1969,30,53848,60082,113930,89.6242
Portugal,1969,31,53656,60120,113776,89.2482
Portugal,1969,32,53824,61118,114942,88.0657
Portugal,1969,33,57709,64221,121930,89.86
Portugal,1969,34,53220,59051,112271,90.1255
Portugal,1969,35,53922,59951,113873,89.9435
Portugal,1969,36,57207,63876,121083,89.5595
Portugal,1969,37,52873,57113,109986,92.5761
Portugal,1969,38,60705,67622,128327,89.7711
Portugal,1969,39,49945,53739,103684,92.94
Portugal,1969,40,55199,60724,115923,90.9015
Portugal,1969,41,51297,57356,108653,89.4362
Portugal,1969,42,52874,59106,111980,89.4562
Portugal,1969,43,55209,61167,116376,90.2595
Portugal,1969,44,50391,56515,106906,89.1639
Portugal,1969,45,49001,53776,102777,91.1206
Portugal,1969,46,50015,56209,106224,88.9804
Portugal,1969,47,47181,50493,97674,93.4407
Portugal,1969,48,56197,62529,118726,89.8735
Portugal,1969,49,37506,40168,77674,93.3728
Portugal,1969,50,40809,45880,86689,88.9473
Portugal,1969,51,41023,45894,86917,89.3864
Portugal,1969,52,40759,46222,86981,88.181
Portugal,1969,53,45355,49579,94934,91.4803
Portugal,1969,54,43004,48779,91783,88.1609
Portugal,1969,55,42301,46501,88802,90.9679
Portugal,1969,56,43668,50620,94288,86.2663
Portugal,1969,57,40526,45389,85915,89.286
Portugal,1969,58,49249,59502,108751,82.7686
Portugal,1969,59,36243,40402,76645,89.706
Portugal,1969,60,37947,45572,83519,83.2682
Portugal,1969,61,36429,44397,80826,82.0528
Portugal,1969,62,34236,43650,77886,78.433
Portugal,1969,63,35705,45772,81477,78.0062
Portugal,1969,64,31435,41288,72723,76.1359
Portugal,1969,65,29823,38854,68677,76.7566
Portugal,1969,66,28987,38300,67287,75.6841
Portugal,1969,67,25522,32146,57668,79.394
Portugal,1969,68,30998,45441,76439,68.2159
Portugal,1969,69,19087,25228,44315,75.658
Portugal,1969,70,20938,29452,50390,71.0919
Portugal,1969,71,18615,26417,45032,70.466
Portugal,1969,72,17420,25951,43371,67.1265
Portugal,1969,73,17338,25876,43214,67.0042
Portugal,1969,74,14532,22133,36665,65.6576
Portugal,1969,75,14008,21201,35209,66.0724
Portugal,1969,76,13473,21380,34853,63.0168
Portugal,1969,77,9988,15543,25531,64.2604
Portugal,1969,78,11361,21315,32676,53.3005
Portugal,1969,79,7907,12880,20787,61.3898
Portugal,1969,80,8403,15584,23987,53.9207
Portugal,1969,81,7169,13899,21068,51.5793
Portugal,1969,82,5832,11991,17823,48.6365
Portugal,1969,83,4830,10212,15042,47.2973
Portugal,1969,84,3849,8628,12477,44.6106
Portugal,1969,85,3047,7124,10171,42.7709
Portugal,1969,86,2455,5804,8259,42.2984
Portugal,1969,87,1914,4796,6710,39.9083
Portugal,1969,88,1463,3807,5270,38.4292
Portugal,1969,89,1073,2883,3956,37.2182
Portugal,1969,90,758,2172,2930,34.8987
Portugal,1969,91,560,1663,2223,33.6741
Portugal,1969,92,383,1204,1587,31.8106
Portugal,1969,93,257,876,1133,29.3379
Portugal,1969,94,156,655,811,23.8168
Portugal,1969,95,86,442,528,19.457
Portugal,1969,96,57,291,348,19.5876
Portugal,1969,97,33,193,226,17.0984
Portugal,1969,98,18,112,130,16.0714
Portugal,1969,99,11,58,69,18.9655
Portugal,1969,100,11,89,100,12.3596
Portugal,1970,0,87821,82976,170797,105.839
Portugal,1970,1,87872,83968,171840,104.6494
Portugal,1970,2,87499,84132,171631,104.002
Portugal,1970,3,88991,85710,174701,103.828
Portugal,1970,4,89390,86253,175643,103.637
Portugal,1970,5,89070,86138,175208,103.4038
Portugal,1970,6,87109,84007,171116,103.6925
Portugal,1970,7,90303,86303,176606,104.6348
Portugal,1970,8,86136,82771,168907,104.0654
Portugal,1970,9,87999,85067,173066,103.4467
Portugal,1970,10,82953,78406,161359,105.7993
Portugal,1970,11,84651,83018,167669,101.967
Portugal,1970,12,80476,79333,159809,101.4408
Portugal,1970,13,78980,78887,157867,100.1179
Portugal,1970,14,76586,77451,154037,98.8832
Portugal,1970,15,74754,76443,151197,97.7905
Portugal,1970,16,72040,75340,147380,95.6199
Portugal,1970,17,74224,80014,154238,92.7638
Portugal,1970,18,66012,70486,136498,93.6526
Portugal,1970,19,70034,75504,145538,92.7554
Portugal,1970,20,62842,67784,130626,92.7092
Portugal,1970,21,63917,71446,135363,89.462
Portugal,1970,22,56425,63284,119709,89.1616
Portugal,1970,23,57158,60678,117836,94.1989
Portugal,1970,24,57220,64465,121685,88.7613
Portugal,1970,25,51756,58874,110630,87.9098
Portugal,1970,26,51643,57217,108860,90.2581
Portugal,1970,27,49109,57331,106440,85.6587
Portugal,1970,28,44113,49906,94019,88.3922
Portugal,1970,29,54571,60868,115439,89.6547
Portugal,1970,30,47763,54052,101815,88.3649
Portugal,1970,31,51995,58297,110292,89.1898
Portugal,1970,32,51931,58526,110457,88.7315
Portugal,1970,33,51994,59536,111530,87.332
Portugal,1970,34,56513,63090,119603,89.5752
Portugal,1970,35,51829,57753,109582,89.7425
Portugal,1970,36,52553,58658,111211,89.5922
Portugal,1970,37,56007,62906,118913,89.0328
Portugal,1970,38,51702,56163,107865,92.057
Portugal,1970,39,59999,67061,127060,89.4693
Portugal,1970,40,48756,52578,101334,92.7308
Portugal,1970,41,54450,59954,114404,90.8196
Portugal,1970,42,50276,56366,106642,89.1956
Portugal,1970,43,51937,58326,110263,89.0461
Portugal,1970,44,54441,60519,114960,89.9569
Portugal,1970,45,49257,55534,104791,88.697
Portugal,1970,46,48106,52978,101084,90.8037
Portugal,1970,47,49103,55596,104699,88.3211
Portugal,1970,48,46376,49786,96162,93.1507
Portugal,1970,49,55663,62177,117840,89.5235
Portugal,1970,50,36808,39687,76495,92.7457
Portugal,1970,51,40097,45363,85460,88.3914
Portugal,1970,52,40335,45285,85620,89.0692
Portugal,1970,53,39905,45511,85416,87.6821
Portugal,1970,54,44618,48916,93534,91.2135
Portugal,1970,55,42211,48257,90468,87.4712
Portugal,1970,56,41378,45653,87031,90.6359
Portugal,1970,57,42696,49767,92463,85.7918
Portugal,1970,58,39447,44502,83949,88.641
Portugal,1970,59,48486,59035,107521,82.1309
Portugal,1970,60,35152,39501,74653,88.9902
Portugal,1970,61,36838,44775,81613,82.2736
Portugal,1970,62,35408,43662,79070,81.0957
Portugal,1970,63,33146,42797,75943,77.4494
Portugal,1970,64,34825,45118,79943,77.1865
Portugal,1970,65,30260,40307,70567,75.0738
Portugal,1970,66,28580,37769,66349,75.6705
Portugal,1970,67,27810,37222,65032,74.7139
Portugal,1970,68,24215,30928,55143,78.2947
Portugal,1970,69,29701,44171,73872,67.2409
Portugal,1970,70,17791,24093,41884,73.843
Portugal,1970,71,19639,28259,47898,69.4964
Portugal,1970,72,17277,24968,42245,69.1966
Portugal,1970,73,16082,24455,40537,65.7616
Portugal,1970,74,16062,24341,40403,65.9874
Portugal,1970,75,13100,20392,33492,64.2409
Portugal,1970,76,12659,19522,32181,64.8448
Portugal,1970,77,12183,19704,31887,61.8301
Portugal,1970,78,8737,13932,22669,62.7117
Portugal,1970,79,10014,19433,29447,51.5309
Portugal,1970,80,8592,15905,24497,54.0207
Portugal,1970,81,7242,13957,21199,51.8879
Portugal,1970,82,6069,12317,18386,49.2734
Portugal,1970,83,4858,10519,15377,46.1831
Portugal,1970,84,3979,8783,12762,45.3034
Portugal,1970,85,3122,7240,10362,43.1215
Portugal,1970,86,2417,5898,8315,40.98
Portugal,1970,87,1893,4762,6655,39.7522
Portugal,1970,88,1436,3866,5302,37.1443
Portugal,1970,89,1072,2969,4041,36.1064
Portugal,1970,90,759,2195,2954,34.5786
Portugal,1970,91,530,1642,2172,32.2777
Portugal,1970,92,394,1232,1626,31.9805
Portugal,1970,93,266,869,1135,30.6099
Portugal,1970,94,175,623,798,28.0899
Portugal,1970,95,101,444,545,22.7477
Portugal,1970,96,53,286,339,18.5315
Portugal,1970,97,37,188,225,19.6809
Portugal,1970,98,21,122,143,17.2131
Portugal,1970,99,10,67,77,14.9254
Portugal,1970,100,12,82,94,14.6341
Portugal,1971,0,73806,70340,144146,104.9275
Portugal,1971,1,74774,71451,146225,104.6507
Portugal,1971,2,83358,80712,164070,103.2783
Portugal,1971,3,83928,80907,164835,103.7339
Portugal,1971,4,86191,83595,169786,103.1054
Portugal,1971,5,87164,84429,171593,103.2394
Portugal,1971,6,86668,84265,170933,102.8517
Portugal,1971,7,85293,82486,167779,103.403
Portugal,1971,8,88738,84924,173662,104.4911
Portugal,1971,9,84656,81372,166028,104.0358
Portugal,1971,10,87669,84982,172651,103.1618
Portugal,1971,11,82335,77800,160135,105.829
Portugal,1971,12,83780,82380,166160,101.6994
Portugal,1971,13,79327,78504,157831,101.0484
Portugal,1971,14,77929,78215,156144,99.6343
Portugal,1971,15,75381,76724,152105,98.2496
Portugal,1971,16,73552,75751,149303,97.0971
Portugal,1971,17,70594,74532,145126,94.7164
Portugal,1971,18,72662,79458,152120,91.4471
Portugal,1971,19,63846,69211,133057,92.2483
Portugal,1971,20,68266,74590,142856,91.5217
Portugal,1971,21,60430,66271,126701,91.1862
Portugal,1971,22,61179,69717,130896,87.7533
Portugal,1971,23,53838,61384,115222,87.7069
Portugal,1971,24,54641,58543,113184,93.3348
Portugal,1971,25,54592,62454,117046,87.4115
Portugal,1971,26,49048,56667,105715,86.5548
Portugal,1971,27,49247,55107,104354,89.3661
Portugal,1971,28,46932,55600,102532,84.4101
Portugal,1971,29,42193,48111,90304,87.6993
Portugal,1971,30,53172,59482,112654,89.3917
Portugal,1971,31,46106,52075,98181,88.5377
Portugal,1971,32,50249,56627,106876,88.7368
Portugal,1971,33,50307,57028,107335,88.2146
Portugal,1971,34,50273,58052,108325,86.5999
Portugal,1971,35,55392,62023,117415,89.3088
Portugal,1971,36,50553,56528,107081,89.43
Portugal,1971,37,51303,57452,108755,89.2972
Portugal,1971,38,54894,62000,116894,88.5387
Portugal,1971,39,50606,55282,105888,91.5416
Portugal,1971,40,59293,66498,125791,89.1651
Portugal,1971,41,47657,51509,99166,92.5217
Portugal,1971,42,53748,59242,112990,90.7262
Portugal,1971,43,49310,55448,104758,88.9302
Portugal,1971,44,51054,57601,108655,88.6339
Portugal,1971,45,53707,59910,113617,89.6461
Portugal,1971,46,48195,54635,102830,88.2127
Portugal,1971,47,47271,52239,99510,90.4899
Portugal,1971,48,48265,54988,103253,87.7737
Portugal,1971,49,45655,49127,94782,92.9326
Portugal,1971,50,55158,61804,116962,89.2467
Portugal,1971,51,36208,39261,75469,92.2238
Portugal,1971,52,39436,44868,84304,87.8934
Portugal,1971,53,39664,44702,84366,88.7298
Portugal,1971,54,39092,44865,83957,87.1325
Portugal,1971,55,43934,48322,92256,90.9193
Portugal,1971,56,41474,47792,89266,86.7802
Portugal,1971,57,40516,44888,85404,90.2602
Portugal,1971,58,41785,48966,90751,85.3347
Portugal,1971,59,38475,43675,82150,88.0939
Portugal,1971,60,47762,58519,106281,81.6179
Portugal,1971,61,34154,38652,72806,88.3628
Portugal,1971,62,35819,44010,79829,81.3883
Portugal,1971,63,34406,42919,77325,80.165
Portugal,1971,64,32062,41977,74039,76.3799
Portugal,1971,65,33973,44490,78463,76.361
Portugal,1971,66,29212,39373,68585,74.193
Portugal,1971,67,27474,36780,64254,74.6982
Portugal,1971,68,26680,36200,62880,73.7017
Portugal,1971,69,22944,29760,52704,77.0968
Portugal,1971,70,28449,42902,71351,66.3116
Portugal,1971,71,16639,22997,39636,72.3529
Portugal,1971,72,18450,27065,45515,68.1692
Portugal,1971,73,16006,23566,39572,67.9199
Portugal,1971,74,14835,23010,37845,64.472
Portugal,1971,75,14887,22840,37727,65.1795
Portugal,1971,76,11806,18765,30571,62.915
Portugal,1971,77,11447,17997,29444,63.605
Portugal,1971,78,11002,18106,29108,60.7644
Portugal,1971,79,7650,12429,20079,61.5496
Portugal,1971,80,8728,16198,24926,53.8832
Portugal,1971,81,7505,14396,21901,52.1325
Portugal,1971,82,6245,12498,18743,49.968
Portugal,1971,83,5132,10872,16004,47.2038
Portugal,1971,84,4044,9171,13215,44.0955
Portugal,1971,85,3251,7549,10800,43.0653
Portugal,1971,86,2533,6107,8640,41.477
Portugal,1971,87,1937,4886,6823,39.6439
Portugal,1971,88,1485,3865,5350,38.4217
Portugal,1971,89,1102,3064,4166,35.9661
Portugal,1971,90,810,2310,3120,35.0649
Portugal,1971,91,567,1704,2271,33.2746
Portugal,1971,92,388,1259,1647,30.8181
Portugal,1971,93,282,906,1188,31.1258
Portugal,1971,94,183,623,806,29.374
Portugal,1971,95,116,439,555,26.4237
Portugal,1971,96,65,314,379,20.7006
Portugal,1971,97,32,194,226,16.4948
Portugal,1971,98,23,120,143,19.1667
Portugal,1971,99,13,81,94,16.0494
Portugal,1971,100,11,91,102,12.0879
Portugal,1972,0,93004,88464,181468,105.132
Portugal,1972,1,73840,70690,144530,104.4561
Portugal,1972,2,75725,72381,148106,104.62
Portugal,1972,3,83510,80887,164397,103.2428
Portugal,1972,4,84088,81103,165191,103.6805
Portugal,1972,5,86320,83714,170034,103.113
Portugal,1972,6,87237,84577,171814,103.1451
Portugal,1972,7,86785,84511,171296,102.6908
Portugal,1972,8,85448,82746,168194,103.2654
Portugal,1972,9,88405,84839,173244,104.2033
Portugal,1972,10,84610,81468,166078,103.8567
Portugal,1972,11,87179,84571,171750,103.0838
Portugal,1972,12,81993,77800,159793,105.3895
Portugal,1972,13,83177,81810,164987,101.6709
Portugal,1972,14,78975,78131,157106,101.0802
Portugal,1972,15,77266,77488,154754,99.7135
Portugal,1972,16,74966,76165,151131,98.4258
Portugal,1972,17,73092,75120,148212,97.3003
Portugal,1972,18,70157,73819,143976,95.0392
Portugal,1972,19,71987,78325,150312,91.9081
Portugal,1972,20,63995,68956,132951,92.8056
Portugal,1972,21,67974,73756,141730,92.1606
Portugal,1972,22,60756,66175,126931,91.8111
Portugal,1972,23,61364,69384,130748,88.4411
Portugal,1972,24,54271,61529,115800,88.2039
Portugal,1972,25,54757,58809,113566,93.1099
Portugal,1972,26,54844,62576,117420,87.6438
Portugal,1972,27,49616,57106,106722,86.884
Portugal,1972,28,49754,55493,105247,89.6582
Portugal,1972,29,47427,55723,103150,85.1121
Portugal,1972,30,42971,48746,91717,88.1529
Portugal,1972,31,53178,59343,112521,89.6112
Portugal,1972,32,47009,52892,99901,88.8773
Portugal,1972,33,50797,57080,107877,88.9926
Portugal,1972,34,50816,57414,108230,88.508
Portugal,1972,35,50874,58457,109331,87.0281
Portugal,1972,36,55546,62096,117642,89.4518
Portugal,1972,37,50987,56938,107925,89.5483
Portugal,1972,38,51762,57876,109638,89.436
Portugal,1972,39,55072,62060,117132,88.7399
Portugal,1972,40,51198,55951,107149,91.5051
Portugal,1972,41,59026,66087,125113,89.3156
Portugal,1972,42,48288,52350,100638,92.2407
Portugal,1972,43,53797,59401,113198,90.5658
Portugal,1972,44,49684,55843,105527,88.9709
Portugal,1972,45,51404,57981,109385,88.6566
Portugal,1972,46,53675,59906,113581,89.5987
Portugal,1972,47,48627,55035,103662,88.3565
Portugal,1972,48,47605,52681,100286,90.3646
Portugal,1972,49,48377,54969,103346,88.0078
Portugal,1972,50,46015,49676,95691,92.6302
Portugal,1972,51,54455,61064,115519,89.1769
Portugal,1972,52,36629,39920,76549,91.756
Portugal,1972,53,39281,44721,84002,87.8357
Portugal,1972,54,39623,44784,84407,88.4758
Portugal,1972,55,39190,45049,84239,86.9942
Portugal,1972,56,43567,48225,91792,90.3411
Portugal,1972,57,41330,47802,89132,86.4608
Portugal,1972,58,40365,45087,85452,89.5269
Portugal,1972,59,41396,48697,90093,85.0073
Portugal,1972,60,38262,43944,82206,87.0699
Portugal,1972,61,46607,57318,103925,81.313
Portugal,1972,62,33985,39019,73004,87.0986
Portugal,1972,63,35185,43609,78794,80.6829
Portugal,1972,64,33710,42508,76218,79.3027
Portugal,1972,65,31367,41433,72800,75.7054
Portugal,1972,66,32841,43469,76310,75.5504
Portugal,1972,67,28316,38678,66994,73.2096
Portugal,1972,68,26545,36229,62774,73.27
Portugal,1972,69,25592,35356,60948,72.3838
Portugal,1972,70,22072,29284,51356,75.3722
Portugal,1972,71,26817,40990,67807,65.4233
Portugal,1972,72,15856,22591,38447,70.1872
Portugal,1972,73,17304,26052,43356,66.421
Portugal,1972,74,14915,22626,37541,65.9197
Portugal,1972,75,13675,21820,35495,62.6719
Portugal,1972,76,13578,21438,35016,63.3361
Portugal,1972,77,10699,17616,28315,60.7346
Portugal,1972,78,10249,16737,26986,61.2356
Portugal,1972,79,9759,16686,26445,58.4862
Portugal,1972,80,8906,16347,25253,54.4809
Portugal,1972,81,7587,14581,22168,52.0335
Portugal,1972,82,6441,12825,19266,50.2222
Portugal,1972,83,5274,10990,16264,47.9891
Portugal,1972,84,4234,9391,13625,45.0857
Portugal,1972,85,3278,7791,11069,42.0742
Portugal,1972,86,2597,6314,8911,41.1308
Portugal,1972,87,1984,5000,6984,39.68
Portugal,1972,88,1482,3903,5385,37.9708
Portugal,1972,89,1099,3029,4128,36.2826
Portugal,1972,90,796,2385,3181,33.3753
Portugal,1972,91,586,1753,2339,33.4284
Portugal,1972,92,390,1253,1643,31.1253
Portugal,1972,93,270,905,1175,29.8343
Portugal,1972,94,206,636,842,32.3899
Portugal,1972,95,121,430,551,28.1395
Portugal,1972,96,76,290,366,26.2069
Portugal,1972,97,44,198,242,22.2222
Portugal,1972,98,20,122,142,16.3934
Portugal,1972,99,15,75,90,20
Portugal,1972,100,14,96,110,14.5833
Portugal,1973,0,87381,82272,169653,106.2099
Portugal,1973,1,91365,87173,178538,104.8088
Portugal,1973,2,75143,71971,147114,104.4073
Portugal,1973,3,76855,73507,150362,104.5547
Portugal,1973,4,83756,81138,164894,103.2266
Portugal,1973,5,84306,81335,165641,103.6528
Portugal,1973,6,86482,83863,170345,103.123
Portugal,1973,7,87347,84768,172115,103.0424
Portugal,1973,8,86931,84788,171719,102.5275
Portugal,1973,9,85619,83014,168633,103.138
Portugal,1973,10,88087,84763,172850,103.9215
Portugal,1973,11,84576,81576,166152,103.6776
Portugal,1973,12,86689,84166,170855,102.9976
Portugal,1973,13,81649,77804,159453,104.9419
Portugal,1973,14,82577,81240,163817,101.6457
Portugal,1973,15,78618,77761,156379,101.1021
Portugal,1973,16,76598,76768,153366,99.7786
Portugal,1973,17,74550,75605,150155,98.6046
Portugal,1973,18,72618,74486,147104,97.4921
Portugal,1973,19,69706,73107,142813,95.3479
Portugal,1973,20,71319,77189,148508,92.3953
Portugal,1973,21,64167,68699,132866,93.4031
Portugal,1973,22,67705,72932,140637,92.833
Portugal,1973,23,61094,66091,127185,92.4392
Portugal,1973,24,61533,69051,130584,89.1124
Portugal,1973,25,54716,61664,116380,88.7325
Portugal,1973,26,54906,59073,113979,92.946
Portugal,1973,27,55118,62700,117818,87.9075
Portugal,1973,28,50201,57547,107748,87.2348
Portugal,1973,29,50278,55890,106168,89.9588
Portugal,1973,30,47932,55853,103785,85.8181
Portugal,1973,31,43754,49383,93137,88.6013
Portugal,1973,32,53182,59209,112391,89.8208
Portugal,1973,33,47915,53719,101634,89.1956
Portugal,1973,34,51349,57544,108893,89.2343
Portugal,1973,35,51324,57810,109134,88.7805
Portugal,1973,36,51480,58860,110340,87.4618
Portugal,1973,37,55700,62173,117873,89.5887
Portugal,1973,38,51421,57357,108778,89.6508
Portugal,1973,39,52241,58328,110569,89.5642
Portugal,1973,40,55286,62146,117432,88.9615
Portugal,1973,41,51831,56622,108453,91.5386
Portugal,1973,42,58792,65669,124461,89.5278
Portugal,1973,43,48929,53183,102112,92.0012
Portugal,1973,44,53856,59561,113417,90.4216
Portugal,1973,45,50080,56237,106317,89.0517
Portugal,1973,46,51778,58358,110136,88.7248
Portugal,1973,47,53671,59925,113596,89.5636
Portugal,1973,48,49061,55444,104505,88.4875
Portugal,1973,49,47906,53126,101032,90.1743
Portugal,1973,50,48455,54978,103433,88.1353
Portugal,1973,51,46359,50239,96598,92.2769
Portugal,1973,52,53740,60318,114058,89.0945
Portugal,1973,53,37045,40565,77610,91.3226
Portugal,1973,54,39115,44564,83679,87.7726
Portugal,1973,55,39564,44865,84429,88.1846
Portugal,1973,56,39303,45238,84541,86.8805
Portugal,1973,57,43221,48131,91352,89.7987
Portugal,1973,58,41189,47791,88980,86.1857
Portugal,1973,59,40207,45287,85494,88.7827
Portugal,1973,60,40994,48430,89424,84.6459
Portugal,1973,61,38068,44186,82254,86.154
Portugal,1973,62,45431,56100,101531,80.9822
Portugal,1973,63,33778,39360,73138,85.8181
Portugal,1973,64,34562,43185,77747,80.0324
Portugal,1973,65,33024,42084,75108,78.4716
Portugal,1973,66,30696,40902,71598,75.0477
Portugal,1973,67,31726,42454,74180,74.7303
Portugal,1973,68,27430,37970,65400,72.2412
Portugal,1973,69,25696,35658,61354,72.0624
Portugal,1973,70,24573,34491,59064,71.2447
Portugal,1973,71,21234,28811,50045,73.701
Portugal,1973,72,25239,39096,64335,64.5565
Portugal,1973,73,15126,22199,37325,68.1382
Portugal,1973,74,16234,25011,41245,64.9074
Portugal,1973,75,13890,21650,35540,64.157
Portugal,1973,76,12643,20686,33329,61.1186
Portugal,1973,77,12444,20149,32593,61.7599
Portugal,1973,78,9691,16521,26212,58.6587
Portugal,1973,79,9189,15522,24711,59.1998
Portugal,1973,80,9148,17081,26229,53.5566
Portugal,1973,81,7808,14879,22687,52.4766
Portugal,1973,82,6560,13097,19657,50.0878
Portugal,1973,83,5512,11358,16870,48.5297
Portugal,1973,84,4465,9647,14112,46.2838
Portugal,1973,85,3507,8090,11597,43.3498
Portugal,1973,86,2678,6614,9292,40.4899
Portugal,1973,87,2070,5249,7319,39.4361
Portugal,1973,88,1535,4078,5613,37.641
Portugal,1973,89,1108,3112,4220,35.6041
Portugal,1973,90,812,2365,3177,34.334
Portugal,1973,91,597,1840,2437,32.4457
Portugal,1973,92,424,1327,1751,31.9518
Portugal,1973,93,277,934,1211,29.6574
Portugal,1973,94,201,665,866,30.2256
Portugal,1973,95,145,458,603,31.6594
Portugal,1973,96,79,295,374,26.7797
Portugal,1973,97,49,189,238,25.9259
Portugal,1973,98,28,128,156,21.875
Portugal,1973,99,11,78,89,14.1026
Portugal,1973,100,16,101,117,15.8416
Portugal,1974,0,85634,81294,166928,105.3386
Portugal,1974,1,86397,81795,168192,105.6263
Portugal,1974,2,90651,86550,177201,104.7383
Portugal,1974,3,76577,73349,149926,104.4009
Portugal,1974,4,78051,74658,152709,104.5447
Portugal,1974,5,84023,81406,165429,103.2148
Portugal,1974,6,84536,81584,166120,103.6184
Portugal,1974,7,86647,84016,170663,103.1315
Portugal,1974,8,87458,84949,172407,102.9535
Portugal,1974,9,87077,85059,172136,102.3725
Portugal,1974,10,85780,83285,169065,102.9957
Portugal,1974,11,87763,84690,172453,103.6285
Portugal,1974,12,84544,81681,166225,103.5051
Portugal,1974,13,86195,83764,169959,102.9022
Portugal,1974,14,81285,77810,159095,104.466
Portugal,1974,15,81957,80665,162622,101.6017
Portugal,1974,16,78252,77386,155638,101.1191
Portugal,1974,17,75917,76047,151964,99.8291
Portugal,1974,18,74113,75042,149155,98.762
Portugal,1974,19,72121,73846,145967,97.6641
Portugal,1974,20,69234,72390,141624,95.6403
Portugal,1974,21,70651,76048,146699,92.9032
Portugal,1974,22,64354,68443,132797,94.0257
Portugal,1974,23,67454,72106,139560,93.5484
Portugal,1974,24,61425,66003,127428,93.064
Portugal,1974,25,61701,68725,130426,89.7796
Portugal,1974,26,55162,61803,116965,89.2546
Portugal,1974,27,55047,59333,114380,92.7764
Portugal,1974,28,55389,62826,118215,88.1625
Portugal,1974,29,50769,57990,108759,87.5479
Portugal,1974,30,50766,56283,107049,90.1978
Portugal,1974,31,48420,55986,104406,86.4859
Portugal,1974,32,44529,50018,94547,89.026
Portugal,1974,33,53165,59069,112234,90.0049
Portugal,1974,34,48805,54542,103347,89.4815
Portugal,1974,35,51906,58003,109909,89.4885
Portugal,1974,36,51830,58199,110029,89.0565
Portugal,1974,37,52081,59248,111329,87.9034
Portugal,1974,38,55864,62228,118092,89.7731
Portugal,1974,39,51843,57759,109602,89.7574
Portugal,1974,40,52679,58756,111435,89.6572
Portugal,1974,41,55451,62204,117655,89.1438
Portugal,1974,42,52410,57265,109675,91.5219
Portugal,1974,43,58510,65232,123742,89.6952
Portugal,1974,44,49542,54007,103549,91.7326
Portugal,1974,45,53875,59717,113592,90.2172
Portugal,1974,46,50430,56628,107058,89.0549
Portugal,1974,47,52131,58717,110848,88.7835
Portugal,1974,48,53645,59910,113555,89.5426
Portugal,1974,49,49470,55831,105301,88.6067
Portugal,1974,50,48199,53538,101737,90.0276
Portugal,1974,51,48523,54940,103463,88.32
Portugal,1974,52,46674,50770,97444,91.9322
Portugal,1974,53,52960,59549,112509,88.9352
Portugal,1974,54,37440,41199,78639,90.876
Portugal,1974,55,38973,44383,83356,87.8106
Portugal,1974,56,39497,44896,84393,87.9744
Portugal,1974,57,39350,45382,84732,86.7084
Portugal,1974,58,42799,47999,90798,89.1664
Portugal,1974,59,40981,47753,88734,85.8187
Portugal,1974,60,39993,45452,85445,87.9895
Portugal,1974,61,40583,48101,88684,84.3704
Portugal,1974,62,37847,44373,82220,85.2929
Portugal,1974,63,44197,54820,99017,80.622
Portugal,1974,64,33526,39633,73159,84.5911
Portugal,1974,65,33898,42699,76597,79.3883
Portugal,1974,66,32264,41595,73859,77.567
Portugal,1974,67,29919,40297,70216,74.2462
Portugal,1974,68,30494,41365,71859,73.7193
Portugal,1974,69,26413,37155,63568,71.0887
Portugal,1974,70,24714,34976,59690,70.6599
Portugal,1974,71,23457,33534,56991,69.9499
Portugal,1974,72,20280,28211,48491,71.8869
Portugal,1974,73,23563,37055,60618,63.5893
Portugal,1974,74,14323,21651,35974,66.154
Portugal,1974,75,15047,23825,38872,63.1563
Portugal,1974,76,12814,20556,33370,62.337
Portugal,1974,77,11527,19433,30960,59.3166
Portugal,1974,78,11191,18688,29879,59.8833
Portugal,1974,79,8658,15231,23889,56.8446
Portugal,1974,80,9405,17275,26680,54.4428
Portugal,1974,81,8002,15463,23465,51.7493
Portugal,1974,82,6720,13307,20027,50.4997
Portugal,1974,83,5548,11544,17092,48.0596
Portugal,1974,84,4576,9871,14447,46.358
Portugal,1974,85,3649,8277,11926,44.086
Portugal,1974,86,2827,6811,9638,41.5064
Portugal,1974,87,2119,5474,7593,38.7103
Portugal,1974,88,1598,4249,5847,37.6088
Portugal,1974,89,1145,3233,4378,35.416
Portugal,1974,90,802,2425,3227,33.0722
Portugal,1974,91,598,1806,2404,33.1118
Portugal,1974,92,433,1399,1832,30.9507
Portugal,1974,93,303,999,1302,30.3303
Portugal,1974,94,189,676,865,27.9586
Portugal,1974,95,135,467,602,28.9079
Portugal,1974,96,96,323,419,29.7214
Portugal,1974,97,50,199,249,25.1256
Portugal,1974,98,31,114,145,27.193
Portugal,1974,99,16,75,91,21.3333
Portugal,1974,100,16,103,119,15.534
Portugal,1975,0,85505,82016,167521,104.254
Portugal,1975,1,85006,81036,166042,104.8991
Portugal,1975,2,86495,82145,168640,105.2955
Portugal,1975,3,90132,86106,176238,104.6756
Portugal,1975,4,78066,74793,152859,104.3761
Portugal,1975,5,79275,75854,155129,104.51
Portugal,1975,6,84321,81693,166014,103.2169
Portugal,1975,7,84790,81841,166631,103.6033
Portugal,1975,8,86839,84187,171026,103.1501
Portugal,1975,9,87589,85139,172728,102.8776
Portugal,1975,10,87234,85332,172566,102.2289
Portugal,1975,11,85951,83560,169511,102.8614
Portugal,1975,12,87447,84616,172063,103.3457
Portugal,1975,13,84510,81786,166296,103.3306
Portugal,1975,14,85699,83360,169059,102.8059
Portugal,1975,15,80925,77818,158743,103.9926
Portugal,1975,16,81325,80095,161420,101.5357
Portugal,1975,17,77858,77007,154865,101.1051
Portugal,1975,18,75221,75317,150538,99.8725
Portugal,1975,19,73658,74475,148133,98.903
Portugal,1975,20,71597,73203,144800,97.8061
Portugal,1975,21,68742,71671,140413,95.9133
Portugal,1975,22,69966,74910,144876,93.4001
Portugal,1975,23,64531,68187,132718,94.6383
Portugal,1975,24,67175,71279,138454,94.2423
Portugal,1975,25,61726,65913,127639,93.6477
Portugal,1975,26,61858,68395,130253,90.4423
Portugal,1975,27,55607,61948,117555,89.764
Portugal,1975,28,55185,59602,114787,92.5892
Portugal,1975,29,55661,62956,118617,88.4125
Portugal,1975,30,51339,58435,109774,87.8566
Portugal,1975,31,51266,56668,107934,90.4673
Portugal,1975,32,48910,56095,105005,87.1914
Portugal,1975,33,45301,50644,95945,89.4499
Portugal,1975,34,53153,58933,112086,90.1923
Portugal,1975,35,49682,55350,105032,89.7597
Portugal,1975,36,52444,58447,110891,89.7292
Portugal,1975,37,52321,58591,110912,89.2987
Portugal,1975,38,52640,59640,112280,88.2629
Portugal,1975,39,55989,62276,118265,89.9046
Portugal,1975,40,52262,58153,110415,89.8698
Portugal,1975,41,53115,59186,112301,89.7425
Portugal,1975,42,55591,62269,117860,89.2756
Portugal,1975,43,52950,57915,110865,91.4271
Portugal,1975,44,58184,64795,122979,89.7971
Portugal,1975,45,50118,54821,104939,91.4212
Portugal,1975,46,53877,59847,113724,90.0246
Portugal,1975,47,50765,56998,107763,89.0645
Portugal,1975,48,52452,59072,111524,88.7933
Portugal,1975,49,53568,59887,113455,89.4485
Portugal,1975,50,49825,56189,106014,88.6739
Portugal,1975,51,48483,53925,102408,89.9082
Portugal,1975,52,48550,54884,103434,88.4593
Portugal,1975,53,46921,51266,98187,91.5246
Portugal,1975,54,52164,58759,110923,88.7762
Portugal,1975,55,37794,41818,79612,90.3773
Portugal,1975,56,38778,44195,82973,87.743
Portugal,1975,57,39386,44945,84331,87.6315
Portugal,1975,58,39341,45533,84874,86.4011
Portugal,1975,59,42336,47832,90168,88.5098
Portugal,1975,60,40725,47658,88383,85.4526
Portugal,1975,61,39706,45555,85261,87.1606
Portugal,1975,62,40051,47709,87760,83.9485
Portugal,1975,63,37496,44478,81974,84.3024
Portugal,1975,64,42889,53453,96342,80.2368
Portugal,1975,65,33162,39839,73001,83.24
Portugal,1975,66,33103,42158,75261,78.5213
Portugal,1975,67,31403,41047,72450,76.505
Portugal,1975,68,29035,39604,68639,73.3133
Portugal,1975,69,29162,40153,69315,72.6272
Portugal,1975,70,25296,36251,61547,69.7801
Portugal,1975,71,23632,34218,57850,69.0631
Portugal,1975,72,22262,32480,54742,68.5406
Portugal,1975,73,19254,27491,46745,70.0375
Portugal,1975,74,21780,34864,56644,62.4713
Portugal,1975,75,13434,20908,34342,64.2529
Portugal,1975,76,13804,22453,36257,61.4795
Portugal,1975,77,11633,19408,31041,59.9392
Portugal,1975,78,10370,18147,28517,57.1444
Portugal,1975,79,9948,17195,27143,57.854
Portugal,1975,80,8981,16693,25674,53.801
Portugal,1975,81,8183,15572,23755,52.5494
Portugal,1975,82,6872,13814,20686,49.7466
Portugal,1975,83,5658,11695,17353,48.3796
Portugal,1975,84,4585,10002,14587,45.8408
Portugal,1975,85,3705,8394,12099,44.1387
Portugal,1975,86,2934,6935,9869,42.3071
Portugal,1975,87,2232,5589,7821,39.9356
Portugal,1975,88,1654,4413,6067,37.4802
Portugal,1975,89,1217,3344,4561,36.3935
Portugal,1975,90,842,2474,3316,34.034
Portugal,1975,91,571,1840,2411,31.0326
Portugal,1975,92,419,1354,1773,30.9453
Portugal,1975,93,299,1022,1321,29.2564
Portugal,1975,94,205,710,915,28.8732
Portugal,1975,95,122,466,588,26.1803
Portugal,1975,96,82,316,398,25.9494
Portugal,1975,97,61,207,268,29.4686
Portugal,1975,98,33,122,155,27.0492
Portugal,1975,99,18,64,82,28.125
Portugal,1975,100,17,98,115,17.3469
Portugal,1976,0,90049,84381,174430,106.7172
Portugal,1976,1,85038,81767,166805,104.0004
Portugal,1976,2,85207,81357,166564,104.7322
Portugal,1976,3,86702,82581,169283,104.9903
Portugal,1976,4,89643,85683,175326,104.6217
Portugal,1976,5,79577,76255,155832,104.3564
Portugal,1976,6,80507,77059,157566,104.4745
Portugal,1976,7,84616,81987,166603,103.2066
Portugal,1976,8,85043,82105,167148,103.5783
Portugal,1976,9,87026,84356,171382,103.1652
Portugal,1976,10,87722,85338,173060,102.7936
Portugal,1976,11,87401,85613,173014,102.0885
Portugal,1976,12,86138,83836,169974,102.7458
Portugal,1976,13,87131,84548,171679,103.0551
Portugal,1976,14,84462,81892,166354,103.1383
Portugal,1976,15,85192,82955,168147,102.6966
Portugal,1976,16,80535,77820,158355,103.4888
Portugal,1976,17,80660,79517,160177,101.4374
Portugal,1976,18,77437,76624,154061,101.061
Portugal,1976,19,74477,74589,149066,99.8498
Portugal,1976,20,73150,73908,147058,98.9744
Portugal,1976,21,71052,72557,143609,97.9258
Portugal,1976,22,68243,70946,139189,96.1901
Portugal,1976,23,69254,73770,143024,93.8783
Portugal,1976,24,64652,67926,132578,95.18
Portugal,1976,25,66857,70444,137301,94.908
Portugal,1976,26,62019,65824,127843,94.2194
Portugal,1976,27,62016,68061,130077,91.1183
Portugal,1976,28,56028,62085,118113,90.244
Portugal,1976,29,55303,59867,115170,92.3764
Portugal,1976,30,55925,63075,119000,88.6643
Portugal,1976,31,51895,58871,110766,88.1504
Portugal,1976,32,51748,57057,108805,90.6953
Portugal,1976,33,49378,56222,105600,87.8268
Portugal,1976,34,46044,51276,97320,89.7964
Portugal,1976,35,53104,58788,111892,90.3314
Portugal,1976,36,50517,56165,106682,89.9439
Portugal,1976,37,52943,58891,111834,89.9
Portugal,1976,38,52793,58966,111759,89.5313
Portugal,1976,39,53200,60019,113219,88.6386
Portugal,1976,40,56084,62314,118398,90.0022
Portugal,1976,41,52630,58540,111170,89.9043
Portugal,1976,42,53492,59608,113100,89.7396
Portugal,1976,43,55663,62321,117984,89.3166
Portugal,1976,44,53458,58545,112003,91.311
Portugal,1976,45,57837,64331,122168,89.9053
Portugal,1976,46,50664,55608,106272,91.1092
Portugal,1976,47,53824,59959,113783,89.768
Portugal,1976,48,50993,57341,108334,88.9294
Portugal,1976,49,52645,59389,112034,88.6444
Portugal,1976,50,53400,59837,113237,89.2424
Portugal,1976,51,50139,56535,106674,88.6867
Portugal,1976,52,48695,54304,102999,89.6711
Portugal,1976,53,48499,54803,103302,88.497
Portugal,1976,54,47089,51745,98834,91.002
Portugal,1976,55,51258,57941,109199,88.4659
Portugal,1976,56,38079,42399,80478,89.8111
Portugal,1976,57,38485,43970,82455,87.5256
Portugal,1976,58,39163,44956,84119,87.1141
Portugal,1976,59,39242,45618,84860,86.0231
Portugal,1976,60,41735,47601,89336,87.6767
Portugal,1976,61,40320,47528,87848,84.8342
Portugal,1976,62,39271,45665,84936,85.998
Portugal,1976,63,39369,47307,86676,83.2202
Portugal,1976,64,37027,44546,81573,83.1208
Portugal,1976,65,41463,52084,93547,79.6079
Portugal,1976,66,32701,40043,72744,81.6647
Portugal,1976,67,32237,41587,73824,77.517
Portugal,1976,68,30455,40407,70862,75.3706
Portugal,1976,69,28042,38775,66817,72.3198
Portugal,1976,70,27732,38838,66570,71.4043
Portugal,1976,71,24169,35281,59450,68.5043
Portugal,1976,72,22556,33386,55942,67.5613
Portugal,1976,73,21043,31364,52407,67.0928
Portugal,1976,74,18251,26740,44991,68.2536
Portugal,1976,75,20030,32660,52690,61.3288
Portugal,1976,76,12542,20210,32752,62.0584
Portugal,1976,77,12614,21168,33782,59.5899
Portugal,1976,78,10574,18232,28806,57.9969
Portugal,1976,79,9296,16788,26084,55.3729
Portugal,1976,80,9075,16926,26001,53.6157
Portugal,1976,81,7846,15150,22996,51.7888
Portugal,1976,82,7088,13995,21083,50.6467
Portugal,1976,83,5890,12267,18157,48.015
Portugal,1976,84,4740,10221,14961,46.3751
Portugal,1976,85,3782,8598,12380,43.987
Portugal,1976,86,3017,7076,10093,42.6371
Portugal,1976,87,2330,5750,8080,40.5217
Portugal,1976,88,1722,4546,6268,37.8795
Portugal,1976,89,1263,3559,4822,35.4875
Portugal,1976,90,908,2652,3560,34.2383
Portugal,1976,91,620,1919,2539,32.3085
Portugal,1976,92,411,1387,1798,29.6323
Portugal,1976,93,292,1009,1301,28.9395
Portugal,1976,94,205,749,954,27.3698
Portugal,1976,95,147,497,644,29.5775
Portugal,1976,96,85,328,413,25.9146
Portugal,1976,97,54,208,262,25.9615
Portugal,1976,98,40,123,163,32.5203
Portugal,1976,99,20,69,89,28.9855
Portugal,1976,100,20,93,113,21.5054
Portugal,1977,0,93322,87754,181076,106.345
Portugal,1977,1,89250,84109,173359,106.1123
Portugal,1977,2,85460,82146,167606,104.0343
Portugal,1977,3,85519,81761,167280,104.5963
Portugal,1977,4,86948,83056,170004,104.686
Portugal,1977,5,89174,85285,174459,104.56
Portugal,1977,6,81097,77721,158818,104.3437
Portugal,1977,7,81754,78271,160025,104.4499
Portugal,1977,8,84915,82292,167207,103.1874
Portugal,1977,9,85286,82378,167664,103.5301
Portugal,1977,10,87208,84531,171739,103.1669
Portugal,1977,11,87853,85528,173381,102.7184
Portugal,1977,12,87559,85883,173442,101.9515
Portugal,1977,13,86306,84107,170413,102.6145
Portugal,1977,14,86807,84477,171284,102.7581
Portugal,1977,15,84416,81998,166414,102.9489
Portugal,1977,16,84665,82544,167209,102.5695
Portugal,1977,17,80125,77814,157939,102.9699
Portugal,1977,18,79981,78929,158910,101.3328
Portugal,1977,19,76989,76228,153217,100.9983
Portugal,1977,20,73721,73857,147578,99.8159
Portugal,1977,21,72664,73345,146009,99.0715
Portugal,1977,22,70531,71912,142443,98.0796
Portugal,1977,23,67749,70219,137968,96.4824
Portugal,1977,24,68543,72619,141162,94.3871
Portugal,1977,25,64788,67661,132449,95.7538
Portugal,1977,26,66562,69611,136173,95.6199
Portugal,1977,27,62330,65727,128057,94.8317
Portugal,1977,28,62171,67718,129889,91.8087
Portugal,1977,29,56460,62218,118678,90.7454
Portugal,1977,30,55426,60120,115546,92.1923
Portugal,1977,31,56172,63184,119356,88.9023
Portugal,1977,32,52436,59309,111745,88.4115
Portugal,1977,33,52208,57440,109648,90.8914
Portugal,1977,34,49836,56337,106173,88.4605
Portugal,1977,35,46795,51897,98692,90.169
Portugal,1977,36,53070,58630,111700,90.5168
Portugal,1977,37,51369,56958,108327,90.1875
Portugal,1977,38,53428,59317,112745,90.072
Portugal,1977,39,53233,59326,112559,89.7296
Portugal,1977,40,53723,60382,114105,88.9719
Portugal,1977,41,56141,62356,118497,90.033
Portugal,1977,42,52974,58934,111908,89.887
Portugal,1977,43,53873,60008,113881,89.7764
Portugal,1977,44,55740,62348,118088,89.4014
Portugal,1977,45,53929,59165,113094,91.1502
Portugal,1977,46,57445,63856,121301,89.9602
Portugal,1977,47,51173,56374,107547,90.7741
Portugal,1977,48,53732,60033,113765,89.5041
Portugal,1977,49,51216,57658,108874,88.8272
Portugal,1977,50,52836,59687,112523,88.5218
Portugal,1977,51,53217,59749,112966,89.0676
Portugal,1977,52,50406,56843,107249,88.6758
Portugal,1977,53,48832,54653,103485,89.3492
Portugal,1977,54,48389,54696,103085,88.469
Portugal,1977,55,47221,52200,99421,90.4617
Portugal,1977,56,50321,57104,107425,88.1217
Portugal,1977,57,38318,42969,81287,89.1759
Portugal,1977,58,38119,43716,81835,87.1969
Portugal,1977,59,38865,44937,83802,86.4877
Portugal,1977,60,39060,45685,84745,85.4985
Portugal,1977,61,41050,47335,88385,86.7223
Portugal,1977,62,39846,47346,87192,84.1592
Portugal,1977,63,38788,45667,84455,84.9366
Portugal,1977,64,38644,46829,85473,82.5215
Portugal,1977,65,36422,44586,81008,81.6893
Portugal,1977,66,39930,50627,90557,78.871
Portugal,1977,67,32175,40116,72291,80.2049
Portugal,1977,68,31237,40875,72112,76.4208
Portugal,1977,69,29376,39667,69043,74.0565
Portugal,1977,70,26930,37883,64813,71.0873
Portugal,1977,71,26196,37450,63646,69.9493
Portugal,1977,72,22911,34201,57112,66.9893
Portugal,1977,73,21260,32373,53633,65.672
Portugal,1977,74,19603,30054,49657,65.2259
Portugal,1977,75,17061,25812,42873,66.0972
Portugal,1977,76,18175,30246,48421,60.0906
Portugal,1977,77,11611,19352,30963,59.999
Portugal,1977,78,11345,19739,31084,57.475
Portugal,1977,79,9415,16864,26279,55.829
Portugal,1977,80,9329,17502,26831,53.3025
Portugal,1977,81,7920,15257,23177,51.9106
Portugal,1977,82,6738,13513,20251,49.8631
Portugal,1977,83,5979,12342,18321,48.4443
Portugal,1977,84,4902,10727,15629,45.6978
Portugal,1977,85,3870,8807,12677,43.9423
Portugal,1977,86,3032,7295,10327,41.5627
Portugal,1977,87,2371,5832,8203,40.655
Portugal,1977,88,1816,4657,6473,38.9951
Portugal,1977,89,1284,3565,4849,36.0168
Portugal,1977,90,932,2722,3654,34.2395
Portugal,1977,91,661,1999,2660,33.0665
Portugal,1977,92,429,1444,1873,29.7091
Portugal,1977,93,281,1019,1300,27.5761
Portugal,1977,94,206,698,904,29.5129
Portugal,1977,95,135,504,639,26.7857
Portugal,1977,96,94,322,416,29.1925
Portugal,1977,97,57,202,259,28.2178
Portugal,1977,98,33,121,154,27.2727
Portugal,1977,99,23,67,90,34.3284
Portugal,1977,100,22,87,109,25.2874
Portugal,1978,0,90585,84638,175223,107.0264
Portugal,1978,1,91655,86636,178291,105.7932
Portugal,1978,2,89188,84344,173532,105.7431
Portugal,1978,3,85948,82598,168546,104.0558
Portugal,1978,4,85853,82199,168052,104.4453
Portugal,1978,5,87202,83564,170766,104.3535
Portugal,1978,6,88717,84914,173631,104.4786
Portugal,1978,7,82642,79204,161846,104.3407
Portugal,1978,8,83019,79496,162515,104.4317
Portugal,1978,9,85227,82603,167830,103.1766
Portugal,1978,10,85546,82654,168200,103.4989
Portugal,1978,11,87401,84712,172113,103.1743
Portugal,1978,12,87996,85739,173735,102.6324
Portugal,1978,13,87727,86168,173895,101.8093
Portugal,1978,14,86474,84381,170855,102.4804
Portugal,1978,15,86479,84407,170886,102.4548
Portugal,1978,16,84353,82098,166451,102.7467
Portugal,1978,17,84119,82129,166248,102.423
Portugal,1978,18,79702,77814,157516,102.4263
Portugal,1978,19,79281,78345,157626,101.1947
Portugal,1978,20,76542,75836,152378,100.931
Portugal,1978,21,72989,73124,146113,99.8154
Portugal,1978,22,72204,72780,144984,99.2086
Portugal,1978,23,70042,71276,141318,98.2687
Portugal,1978,24,67284,69497,136781,96.8157
Portugal,1978,25,67858,71473,139331,94.9421
Portugal,1978,26,64948,67405,132353,96.3549
Portugal,1978,27,66269,68784,135053,96.3436
Portugal,1978,28,62636,65643,128279,95.4192
Portugal,1978,29,62328,67391,129719,92.4871
Portugal,1978,30,56883,62357,119240,91.2215
Portugal,1978,31,55551,60369,115920,92.0191
Portugal,1978,32,56428,63292,119720,89.155
Portugal,1978,33,52989,59745,112734,88.6919
Portugal,1978,34,52686,57818,110504,91.1239
Portugal,1978,35,50304,56446,106750,89.1188
Portugal,1978,36,47546,52511,100057,90.5448
Portugal,1978,37,53030,58476,111506,90.6868
Portugal,1978,38,52216,57757,109973,90.4064
Portugal,1978,39,53923,59734,113657,90.2719
Portugal,1978,40,53696,59682,113378,89.9702
Portugal,1978,41,54267,60755,115022,89.321
Portugal,1978,42,56217,62392,118609,90.1029
Portugal,1978,43,53314,59310,112624,89.8904
Portugal,1978,44,54234,60416,114650,89.7676
Portugal,1978,45,55810,62383,118193,89.4635
Portugal,1978,46,54416,59778,114194,91.0301
Portugal,1978,47,57062,63380,120442,90.0316
Portugal,1978,48,51661,57145,108806,90.4034
Portugal,1978,49,53646,60111,113757,89.2449
Portugal,1978,50,51458,57966,109424,88.7727
Portugal,1978,51,53054,59977,113031,88.4572
Portugal,1978,52,53041,59673,112714,88.8861
Portugal,1978,53,50647,57157,107804,88.6103
Portugal,1978,54,48958,55001,103959,89.0129
Portugal,1978,55,48290,54593,102883,88.4546
Portugal,1978,56,47347,52626,99973,89.9688
Portugal,1978,57,49357,56236,105593,87.7676
Portugal,1978,58,38561,43534,82095,88.5767
Portugal,1978,59,37779,43453,81232,86.9422
Portugal,1978,60,38556,44894,83450,85.8823
Portugal,1978,61,38869,45735,84604,84.9874
Portugal,1978,62,40395,47059,87454,85.8391
Portugal,1978,63,39354,47151,86505,83.4638
Portugal,1978,64,38271,45657,83928,83.8229
Portugal,1978,65,37944,46333,84277,81.8941
Portugal,1978,66,35878,44585,80463,80.471
Portugal,1978,67,38401,49128,87529,78.1652
Portugal,1978,68,31590,40153,71743,78.6741
Portugal,1978,69,30203,40154,70357,75.2179
Portugal,1978,70,28270,38906,67176,72.6623
Portugal,1978,71,25824,36941,62765,69.9061
Portugal,1978,72,24683,36031,60714,68.5049
Portugal,1978,73,21668,33052,54720,65.5573
Portugal,1978,74,20089,31291,51380,64.2006
Portugal,1978,75,18305,28743,47048,63.6851
Portugal,1978,76,15948,24946,40894,63.9301
Portugal,1978,77,16357,27968,44325,58.4847
Portugal,1978,78,10719,18573,29292,57.7128
Portugal,1978,79,10178,18342,28520,55.4901
Portugal,1978,80,9828,18130,27958,54.2085
Portugal,1978,81,8207,15955,24162,51.4384
Portugal,1978,82,6853,13707,20560,49.9964
Portugal,1978,83,5732,12013,17745,47.715
Portugal,1978,84,4999,10825,15824,46.1801
Portugal,1978,85,4048,9341,13389,43.3358
Portugal,1978,86,3152,7541,10693,41.7982
Portugal,1978,87,2411,6116,8527,39.4212
Portugal,1978,88,1846,4797,6643,38.4824
Portugal,1978,89,1422,3793,5215,37.4901
Portugal,1978,90,962,2825,3787,34.0531
Portugal,1978,91,678,2118,2796,32.0113
Portugal,1978,92,468,1531,1999,30.5683
Portugal,1978,93,294,1094,1388,26.8739
Portugal,1978,94,186,749,935,24.8331
Portugal,1978,95,136,485,621,28.0412
Portugal,1978,96,88,350,438,25.1429
Portugal,1978,97,61,219,280,27.8539
Portugal,1978,98,36,128,164,28.125
Portugal,1978,99,21,70,91,30
Portugal,1978,100,25,81,106,30.8642
Portugal,1979,0,84058,78225,162283,107.4567
Portugal,1979,1,88041,82927,170968,106.1669
Portugal,1979,2,90648,85951,176599,105.4647
Portugal,1979,3,89179,84628,173807,105.3777
Portugal,1979,4,86468,83085,169553,104.0717
Portugal,1979,5,86210,82663,168873,104.2909
Portugal,1979,6,87470,84072,171542,104.0418
Portugal,1979,7,88263,84546,172809,104.3964
Portugal,1979,8,84184,80695,164879,104.3237
Portugal,1979,9,84284,80723,165007,104.4114
Portugal,1979,10,85542,82911,168453,103.1733
Portugal,1979,11,85808,82930,168738,103.4704
Portugal,1979,12,87597,84894,172491,103.184
Portugal,1979,13,88128,85937,174065,102.5495
Portugal,1979,14,87876,86436,174312,101.666
Portugal,1979,15,86631,84644,171275,102.3475
Portugal,1979,16,86132,84325,170457,102.1429
Portugal,1979,17,84257,82191,166448,102.5137
Portugal,1979,18,83535,81710,165245,102.2335
Portugal,1979,19,79249,77810,157059,101.8494
Portugal,1979,20,78569,77764,156333,101.0352
Portugal,1979,21,76094,75446,151540,100.8589
Portugal,1979,22,72242,72393,144635,99.7914
Portugal,1979,23,71709,72216,143925,99.2979
Portugal,1979,24,69535,70640,140175,98.4357
Portugal,1979,25,66818,68783,135601,97.1432
Portugal,1979,26,67172,70329,137501,95.5111
Portugal,1979,27,65109,67146,132255,96.9663
Portugal,1979,28,65984,67956,133940,97.0981
Portugal,1979,29,62958,65557,128515,96.0355
Portugal,1979,30,62495,67064,129559,93.1871
Portugal,1979,31,57305,62502,119807,91.6851
Portugal,1979,32,55672,60631,116303,91.821
Portugal,1979,33,56692,63398,120090,89.4224
Portugal,1979,34,53543,60173,113716,88.9818
Portugal,1979,35,53169,58197,111366,91.3604
Portugal,1979,36,50767,56556,107323,89.7641
Portugal,1979,37,48291,53131,101422,90.8904
Portugal,1979,38,53004,58321,111325,90.8832
Portugal,1979,39,53069,58551,111620,90.6372
Portugal,1979,40,54408,60158,114566,90.4418
Portugal,1979,41,54132,60049,114181,90.1464
Portugal,1979,42,54791,61129,115920,89.6318
Portugal,1979,43,56293,62427,118720,90.1741
Portugal,1979,44,53654,59686,113340,89.8938
Portugal,1979,45,54595,60822,115417,89.7619
Portugal,1979,46,55895,62421,118316,89.5452
Portugal,1979,47,54880,60388,115268,90.879
Portugal,1979,48,56630,62894,119524,90.0404
Portugal,1979,49,52152,57909,110061,90.0585
Portugal,1979,50,53560,60186,113746,88.9908
Portugal,1979,51,51666,58297,109963,88.6255
Portugal,1979,52,53237,60295,113532,88.2942
Portugal,1979,53,52839,59603,112442,88.6516
Portugal,1979,54,50894,57476,108370,88.5483
Portugal,1979,55,49104,55351,104455,88.7138
Portugal,1979,56,48164,54492,102656,88.3873
Portugal,1979,57,47447,53069,100516,89.4062
Portugal,1979,58,48376,55353,103729,87.3954
Portugal,1979,59,38763,44071,82834,87.9558
Portugal,1979,60,37427,43173,80600,86.6908
Portugal,1979,61,38273,44828,83101,85.3774
Portugal,1979,62,38661,45731,84392,84.54
Portugal,1979,63,39704,46738,86442,84.9501
Portugal,1979,64,38888,46912,85800,82.8956
Portugal,1979,65,37732,45576,83308,82.7892
Portugal,1979,66,37116,45747,82863,81.1332
Portugal,1979,67,35244,44501,79745,79.1982
Portugal,1979,68,36832,47603,84435,77.3733
Portugal,1979,69,31013,40158,71171,77.2275
Portugal,1979,70,29222,39319,68541,74.3203
Portugal,1979,71,27202,38016,65218,71.5541
Portugal,1979,72,24716,35907,60623,68.8334
Portugal,1979,73,23127,34517,57644,67.0018
Portugal,1979,74,20401,31818,52219,64.1178
Portugal,1979,75,18906,30123,49029,62.7627
Portugal,1979,76,16993,27318,44311,62.2044
Portugal,1979,77,14846,23947,38793,61.9952
Portugal,1979,78,14541,25539,40080,56.9365
Portugal,1979,79,9818,17678,27496,55.538
Portugal,1979,80,10268,19313,29581,53.1663
Portugal,1979,81,8638,16503,25141,52.342
Portugal,1979,82,7113,14375,21488,49.4817
Portugal,1979,83,5839,12135,17974,48.117
Portugal,1979,84,4845,10522,15367,46.0464
Portugal,1979,85,4142,9352,13494,44.29
Portugal,1979,86,3299,7965,11264,41.4187
Portugal,1979,87,2528,6229,8757,40.5844
Portugal,1979,88,1904,4984,6888,38.2022
Portugal,1979,89,1419,3828,5247,37.069
Portugal,1979,90,1087,2951,4038,36.835
Portugal,1979,91,698,2152,2850,32.4349
Portugal,1979,92,478,1591,2069,30.044
Portugal,1979,93,324,1121,1445,28.9028
Portugal,1979,94,206,790,996,26.0759
Portugal,1979,95,130,522,652,24.9042
Portugal,1979,96,97,331,428,29.3051
Portugal,1979,97,60,238,298,25.2101
Portugal,1979,98,43,137,180,31.3869
Portugal,1979,99,27,64,91,42.1875
Portugal,1979,100,30,77,107,38.961
Portugal,1980,0,80783,76428,157211,105.6982
Portugal,1980,1,81691,76859,158550,106.2868
Portugal,1980,2,86057,81604,167661,105.4568
Portugal,1980,3,89710,85317,175027,105.149
Portugal,1980,4,89218,84953,174171,105.0204
Portugal,1980,5,87005,83595,170600,104.0792
Portugal,1980,6,86569,83136,169705,104.1294
Portugal,1980,7,87750,84593,172343,103.732
Portugal,1980,8,87832,84185,172017,104.3321
Portugal,1980,9,85738,82187,167925,104.3206
Portugal,1980,10,85555,81957,167512,104.3901
Portugal,1980,11,85854,83227,169081,103.1564
Portugal,1980,12,86067,83205,169272,103.4397
Portugal,1980,13,87787,85071,172858,103.1926
Portugal,1980,14,88256,86128,174384,102.4707
Portugal,1980,15,88023,86701,174724,101.5248
Portugal,1980,16,86755,84904,171659,102.1801
Portugal,1980,17,85738,84242,169980,101.7758
Portugal,1980,18,84138,82281,166419,102.2569
Portugal,1980,19,82954,81289,164243,102.0482
Portugal,1980,20,78807,77807,156614,101.2852
Portugal,1980,21,77868,77177,155045,100.8953
Portugal,1980,22,75655,75058,150713,100.7954
Portugal,1980,23,71509,71667,143176,99.7795
Portugal,1980,24,71238,71656,142894,99.4167
Portugal,1980,25,69033,70004,139037,98.6129
Portugal,1980,26,66351,68064,134415,97.4833
Portugal,1980,27,66492,69189,135681,96.102
Portugal,1980,28,65265,66882,132147,97.5823
Portugal,1980,29,65698,67123,132821,97.877
Portugal,1980,30,63280,65473,128753,96.6505
Portugal,1980,31,62658,66736,129394,93.8894
Portugal,1980,32,57730,62643,120373,92.1571
Portugal,1980,33,55787,60888,116675,91.6223
Portugal,1980,34,56941,63512,120453,89.6539
Portugal,1980,35,54086,60596,114682,89.2567
Portugal,1980,36,53639,58572,112211,91.5779
Portugal,1980,37,51230,56679,107909,90.3862
Portugal,1980,38,49032,53756,102788,91.2121
Portugal,1980,39,52956,58159,111115,91.0538
Portugal,1980,40,53909,59335,113244,90.8553
Portugal,1980,41,54895,60578,115473,90.6187
Portugal,1980,42,54581,60408,114989,90.3539
Portugal,1980,43,55313,61488,116801,89.9574
Portugal,1980,44,56353,62457,118810,90.2269
Portugal,1980,45,53992,60064,114056,89.8908
Portugal,1980,46,54954,61219,116173,89.7662
Portugal,1980,47,55968,62435,118403,89.642
Portugal,1980,48,55356,60974,116330,90.7862
Portugal,1980,49,56233,62401,118634,90.1155
Portugal,1980,50,52639,58671,111310,89.7189
Portugal,1980,51,53429,60260,113689,88.6641
Portugal,1980,52,51843,58598,110441,88.4723
Portugal,1980,53,53386,60563,113949,88.1495
Portugal,1980,54,52617,59513,112130,88.4126
Portugal,1980,55,51122,57783,108905,88.4724
Portugal,1980,56,49215,55671,104886,88.4033
Portugal,1980,57,48028,54364,102392,88.3452
Portugal,1980,58,47557,53488,101045,88.9115
Portugal,1980,59,47413,54461,101874,87.0586
Portugal,1980,60,38960,44608,83568,87.3386
Portugal,1980,61,37032,42900,79932,86.3217
Portugal,1980,62,37937,44749,82686,84.7773
Portugal,1980,63,38416,45735,84151,83.9969
Portugal,1980,64,39000,46432,85432,83.9938
Portugal,1980,65,38417,46681,85098,82.2969
Portugal,1980,66,37201,45515,82716,81.7335
Portugal,1980,67,36332,45135,81467,80.4963
Portugal,1980,68,34619,44359,78978,78.0428
Portugal,1980,69,35232,46033,81265,76.5364
Portugal,1980,70,30398,40079,70477,75.8452
Portugal,1980,71,28190,38419,66609,73.3752
Portugal,1980,72,26077,37117,63194,70.2562
Portugal,1980,73,23573,34830,58403,67.6802
Portugal,1980,74,21624,32919,54543,65.6885
Portugal,1980,75,19206,30517,49723,62.9354
Portugal,1980,76,17707,28941,46648,61.1831
Portugal,1980,77,15651,25900,41551,60.4286
Portugal,1980,78,13791,22967,36758,60.047
Portugal,1980,79,12871,23137,36008,55.6295
Portugal,1980,80,10293,19103,29396,53.8816
Portugal,1980,81,9083,17659,26742,51.4355
Portugal,1980,82,7544,14907,22451,50.6071
Portugal,1980,83,6142,12845,18987,47.8163
Portugal,1980,84,4975,10658,15633,46.6786
Portugal,1980,85,4069,9126,13195,44.5869
Portugal,1980,86,3407,7994,11401,42.6195
Portugal,1980,87,2685,6787,9472,39.5609
Portugal,1980,88,2031,5195,7226,39.0953
Portugal,1980,89,1484,4028,5512,36.8421
Portugal,1980,90,1061,3012,4073,35.2258
Portugal,1980,91,826,2335,3161,35.3747
Portugal,1980,92,498,1660,2158,30
Portugal,1980,93,345,1193,1538,28.9187
Portugal,1980,94,230,800,1030,28.75
Portugal,1980,95,136,561,697,24.2424
Portugal,1980,96,83,366,449,22.6776
Portugal,1980,97,64,223,287,28.6996
Portugal,1980,98,41,158,199,25.9494
Portugal,1980,99,33,83,116,39.759
Portugal,1980,100,38,81,119,46.9136
Portugal,1981,0,77065,73585,150650,104.7292
Portugal,1981,1,80300,76617,156917,104.807
Portugal,1981,2,79760,75806,155566,105.2159
Portugal,1981,3,84132,80350,164482,104.7069
Portugal,1981,4,88796,84706,173502,104.8285
Portugal,1981,5,89264,85295,174559,104.6533
Portugal,1981,6,87566,84112,171678,104.1064
Portugal,1981,7,86936,83618,170554,103.968
Portugal,1981,8,88030,85116,173146,103.4236
Portugal,1981,9,87393,83818,171211,104.2652
Portugal,1981,10,87272,83685,170957,104.2863
Portugal,1981,11,86823,83184,170007,104.3746
Portugal,1981,12,86171,83548,169719,103.1395
Portugal,1981,13,86335,83489,169824,103.4088
Portugal,1981,14,87981,85246,173227,103.2084
Portugal,1981,15,88368,86320,174688,102.3726
Portugal,1981,16,88128,86980,175108,101.3198
Portugal,1981,17,86869,85167,172036,101.9984
Portugal,1981,18,85328,84156,169484,101.3927
Portugal,1981,19,83967,82367,166334,101.9425
Portugal,1981,20,82347,80857,163204,101.8428
Portugal,1981,21,78343,77801,156144,100.6966
Portugal,1981,22,77193,76601,153794,100.7728
Portugal,1981,23,75239,74648,149887,100.7917
Portugal,1981,24,70795,70944,141739,99.79
Portugal,1981,25,70782,71097,141879,99.5569
Portugal,1981,26,68548,69361,137909,98.8279
Portugal,1981,27,65898,67345,133243,97.8514
Portugal,1981,28,65809,68039,133848,96.7225
Portugal,1981,29,65435,66630,132065,98.2065
Portugal,1981,30,65405,66292,131697,98.662
Portugal,1981,31,63576,65385,128961,97.2333
Portugal,1981,32,62809,66395,129204,94.599
Portugal,1981,33,58152,62775,120927,92.6356
Portugal,1981,34,55896,61133,117029,91.4334
Portugal,1981,35,57181,63631,120812,89.8634
Portugal,1981,36,54622,61022,115644,89.512
Portugal,1981,37,54123,58929,113052,91.8444
Portugal,1981,38,51678,56795,108473,90.9904
Portugal,1981,39,49754,54362,104116,91.5235
Portugal,1981,40,52897,57988,110885,91.2206
Portugal,1981,41,54732,60102,114834,91.0652
Portugal,1981,42,55358,61000,116358,90.7508
Portugal,1981,43,55006,60770,115776,90.5151
Portugal,1981,44,55797,61827,117624,90.247
Portugal,1981,45,56372,62459,118831,90.2544
Portugal,1981,46,54306,60443,114749,89.8466
Portugal,1981,47,55272,61585,116857,89.7491
Portugal,1981,48,55990,62429,118419,89.6859
Portugal,1981,49,55773,61580,117353,90.57
Portugal,1981,50,55792,61910,117702,90.1179
Portugal,1981,51,53067,59438,112505,89.2813
Portugal,1981,52,53232,60304,113536,88.2728
Portugal,1981,53,51971,58895,110866,88.2435
Portugal,1981,54,53519,60803,114322,88.0203
Portugal,1981,55,52319,59417,111736,88.0539
Portugal,1981,56,51300,58062,109362,88.3538
Portugal,1981,57,49266,55992,105258,87.9876
Portugal,1981,58,47798,54213,102011,88.167
Portugal,1981,59,47596,53846,101442,88.3928
Portugal,1981,60,46340,53538,99878,86.5553
Portugal,1981,61,39115,45089,84204,86.7506
Portugal,1981,62,36523,42573,79096,85.7891
Portugal,1981,63,37533,44615,82148,84.1264
Portugal,1981,64,38116,45672,83788,83.4559
Portugal,1981,65,38159,46102,84261,82.7708
Portugal,1981,66,37850,46371,84221,81.6243
Portugal,1981,67,36518,45310,81828,80.5959
Portugal,1981,68,35447,44448,79895,79.7494
Portugal,1981,69,33985,44212,78197,76.8683
Portugal,1981,70,33477,44304,77781,75.562
Portugal,1981,71,29716,39948,69664,74.3867
Portugal,1981,72,27023,37487,64510,72.0863
Portugal,1981,73,24956,36104,61060,69.1225
Portugal,1981,74,22428,33675,56103,66.6013
Portugal,1981,75,20041,31233,51274,64.1661
Portugal,1981,76,18026,29160,47186,61.8176
Portugal,1981,77,16469,27645,44114,59.5732
Portugal,1981,78,14348,24288,38636,59.0744
Portugal,1981,79,12690,21877,34567,58.0061
Portugal,1981,80,11460,20893,32353,54.8509
Portugal,1981,81,9123,17465,26588,52.2359
Portugal,1981,82,7885,16035,23920,49.1737
Portugal,1981,83,6506,13296,19802,48.932
Portugal,1981,84,5193,11363,16556,45.701
Portugal,1981,85,4168,9326,13494,44.6923
Portugal,1981,86,3397,7882,11279,43.0982
Portugal,1981,87,2724,6741,9465,40.4094
Portugal,1981,88,2141,5652,7793,37.8804
Portugal,1981,89,1579,4206,5785,37.5416
Portugal,1981,90,1134,3204,4338,35.3933
Portugal,1981,91,807,2380,3187,33.9076
Portugal,1981,92,594,1757,2351,33.8076
Portugal,1981,93,349,1254,1603,27.8309
Portugal,1981,94,233,857,1090,27.1879
Portugal,1981,95,152,584,736,26.0274
Portugal,1981,96,89,398,487,22.3618
Portugal,1981,97,47,236,283,19.9153
Portugal,1981,98,39,157,196,24.8408
Portugal,1981,99,24,104,128,23.0769
Portugal,1981,100,31,104,135,29.8077
Portugal,1982,0,75866,71984,147850,105.3929
Portugal,1982,1,75650,72546,148196,104.2787
Portugal,1982,2,79929,76437,156366,104.5685
Portugal,1982,3,79235,75521,154756,104.9178
Portugal,1982,4,83647,80100,163747,104.4282
Portugal,1982,5,88490,84533,173023,104.681
Portugal,1982,6,89232,85369,174601,104.5251
Portugal,1982,7,87599,84240,171839,103.9874
Portugal,1982,8,86843,83603,170446,103.8755
Portugal,1982,9,87854,85058,172912,103.2872
Portugal,1982,10,86985,83520,170505,104.1487
Portugal,1982,11,87148,83579,170727,104.2702
Portugal,1982,12,86460,82887,169347,104.3107
Portugal,1982,13,85567,82993,168560,103.1015
Portugal,1982,14,85599,82893,168492,103.2644
Portugal,1982,15,87069,84471,171540,103.0756
Portugal,1982,16,87318,85474,172792,102.1574
Portugal,1982,17,87044,86160,173204,101.026
Portugal,1982,18,85756,84351,170107,101.6657
Portugal,1982,19,84133,83358,167491,100.9297
Portugal,1982,20,82906,81708,164614,101.4662
Portugal,1982,21,81431,80202,161633,101.5324
Portugal,1982,22,77525,77352,154877,100.2237
Portugal,1982,23,76354,76078,152432,100.3628
Portugal,1982,24,74669,74388,149057,100.3777
Portugal,1982,25,70235,70629,140864,99.4422
Portugal,1982,26,70368,70920,141288,99.2217
Portugal,1982,27,68252,69177,137429,98.6629
Portugal,1982,28,65619,67195,132814,97.6546
Portugal,1982,29,65573,67892,133465,96.5843
Portugal,1982,30,65361,66660,132021,98.0513
Portugal,1982,31,65343,66220,131563,98.6756
Portugal,1982,32,63682,65472,129154,97.266
Portugal,1982,33,62971,66508,129479,94.6818
Portugal,1982,34,58364,62961,121325,92.6987
Portugal,1982,35,56016,61262,117278,91.4368
Portugal,1982,36,57461,63839,121300,90.0092
Portugal,1982,37,54868,61225,116093,89.617
Portugal,1982,38,54273,59094,113367,91.8418
Portugal,1982,39,51860,56917,108777,91.1151
Portugal,1982,40,49898,54482,104380,91.5862
Portugal,1982,41,52863,57895,110758,91.3084
Portugal,1982,42,54851,60211,115062,91.098
Portugal,1982,43,55440,61032,116472,90.8376
Portugal,1982,44,55019,60753,115772,90.5618
Portugal,1982,45,55797,61834,117631,90.2368
Portugal,1982,46,56348,62467,118815,90.2044
Portugal,1982,47,54283,60430,114713,89.8279
Portugal,1982,48,55182,61510,116692,89.7122
Portugal,1982,49,55844,62387,118231,89.5122
Portugal,1982,50,55716,61607,117323,90.4378
Portugal,1982,51,55539,61765,117304,89.9199
Portugal,1982,52,52947,59508,112455,88.9746
Portugal,1982,53,53001,60192,113193,88.0532
Portugal,1982,54,51702,58768,110470,87.9764
Portugal,1982,55,53281,60693,113974,87.7877
Portugal,1982,56,51989,59218,111207,87.7926
Portugal,1982,57,50992,57932,108924,88.0204
Portugal,1982,58,48874,55827,104701,87.5455
Portugal,1982,59,47348,53905,101253,87.836
Portugal,1982,60,47053,53510,100563,87.9331
Portugal,1982,61,45615,53103,98718,85.8991
Portugal,1982,62,38626,44968,83594,85.8966
Portugal,1982,63,35860,42044,77904,85.2916
Portugal,1982,64,36769,44137,80906,83.3065
Portugal,1982,65,37242,45101,82343,82.5747
Portugal,1982,66,37202,45346,82548,82.0403
Portugal,1982,67,36884,45703,82587,80.7037
Portugal,1982,68,35399,44540,79939,79.4769
Portugal,1982,69,34279,43514,77793,78.7769
Portugal,1982,70,32827,43299,76126,75.8147
Portugal,1982,71,31940,43012,74952,74.2583
Portugal,1982,72,28407,38907,67314,73.0126
Portugal,1982,73,25663,36255,61918,70.7847
Portugal,1982,74,23553,34800,58353,67.681
Portugal,1982,75,20901,32243,53144,64.8234
Portugal,1982,76,18503,29671,48174,62.3606
Portugal,1982,77,16543,27607,44150,59.9232
Portugal,1982,78,15033,26100,41133,57.5977
Portugal,1982,79,12990,22647,35637,57.3586
Portugal,1982,80,11862,21522,33384,55.1157
Portugal,1982,81,10139,19098,29237,53.0893
Portugal,1982,82,7959,15832,23791,50.2716
Portugal,1982,83,6831,14352,21183,47.5962
Portugal,1982,84,5527,11758,17285,47.0063
Portugal,1982,85,4294,9889,14183,43.422
Portugal,1982,86,3409,7989,11398,42.6712
Portugal,1982,87,2826,6598,9424,42.8312
Portugal,1982,88,2149,5652,7801,38.0219
Portugal,1982,89,1669,4578,6247,36.457
Portugal,1982,90,1234,3420,4654,36.0819
Portugal,1982,91,844,2493,3337,33.8548
Portugal,1982,92,605,1831,2436,33.0421
Portugal,1982,93,430,1318,1748,32.6252
Portugal,1982,94,235,930,1165,25.2688
Portugal,1982,95,164,627,791,26.1563
Portugal,1982,96,103,405,508,25.4321
Portugal,1982,97,56,271,327,20.6642
Portugal,1982,98,34,159,193,21.3836
Portugal,1982,99,19,101,120,18.8119
Portugal,1982,100,29,124,153,23.3871
Portugal,1983,0,76033,71826,147859,105.8572
Portugal,1983,1,75231,71477,146708,105.252
Portugal,1983,2,75515,72407,147922,104.2924
Portugal,1983,3,79556,76124,155680,104.5084
Portugal,1983,4,79091,75440,154531,104.8396
Portugal,1983,5,83553,80100,163653,104.3109
Portugal,1983,6,88348,84471,172819,104.5897
Portugal,1983,7,89175,85368,174543,104.4595
Portugal,1983,8,87481,84262,171743,103.8202
Portugal,1983,9,86625,83469,170094,103.781
Portugal,1983,10,87550,84861,172411,103.1687
Portugal,1983,11,86585,83233,169818,104.0272
Portugal,1983,12,86600,83069,169669,104.2507
Portugal,1983,13,85663,82198,167861,104.2154
Portugal,1983,14,84728,82221,166949,103.0491
Portugal,1983,15,84590,82077,166667,103.0618
Portugal,1983,16,85819,83457,169276,102.8302
Portugal,1983,17,85945,84354,170299,101.8861
Portugal,1983,18,85663,85062,170725,100.7065
Portugal,1983,19,84346,83268,167614,101.2946
Portugal,1983,20,82786,82372,165158,100.5026
Portugal,1983,21,81645,80843,162488,100.992
Portugal,1983,22,80433,79501,159934,101.1723
Portugal,1983,23,76647,76793,153440,99.8099
Portugal,1983,24,75527,75573,151100,99.9391
Portugal,1983,25,74083,74159,148242,99.8975
Portugal,1983,26,69729,70416,140145,99.0244
Portugal,1983,27,70002,70840,140842,98.8171
Portugal,1983,28,67999,69108,137107,98.3953
Portugal,1983,29,65381,67193,132574,97.3033
Portugal,1983,30,65453,68012,133465,96.2374
Portugal,1983,31,65274,66760,132034,97.7741
Portugal,1983,32,65324,66353,131677,98.4492
Portugal,1983,33,63723,65596,129319,97.1446
Portugal,1983,34,63150,66731,129881,94.6337
Portugal,1983,35,58518,63152,121670,92.6621
Portugal,1983,36,56144,61352,117496,91.5113
Portugal,1983,37,57743,64070,121813,90.1249
Portugal,1983,38,55041,61371,116412,89.6857
Portugal,1983,39,54365,59195,113560,91.8405
Portugal,1983,40,52012,57021,109033,91.2155
Portugal,1983,41,49933,54464,104397,91.6807
Portugal,1983,42,52860,57813,110673,91.4327
Portugal,1983,43,54765,60161,114926,91.0307
Portugal,1983,44,55402,60952,116354,90.8945
Portugal,1983,45,54905,60661,115566,90.5112
Portugal,1983,46,55715,61746,117461,90.2326
Portugal,1983,47,56356,62450,118806,90.2418
Portugal,1983,48,54132,60314,114446,89.7503
Portugal,1983,49,54993,61380,116373,89.5943
Portugal,1983,50,55680,62310,117990,89.3597
Portugal,1983,51,55514,61506,117020,90.2579
Portugal,1983,52,55349,61678,117027,89.7386
Portugal,1983,53,52725,59381,112106,88.791
Portugal,1983,54,52774,60054,112828,87.8776
Portugal,1983,55,51318,58531,109849,87.6766
Portugal,1983,56,52932,60508,113440,87.4793
Portugal,1983,57,51572,59029,110601,87.3672
Portugal,1983,58,50583,57644,108227,87.7507
Portugal,1983,59,48457,55546,104003,87.2376
Portugal,1983,60,46756,53568,100324,87.2835
Portugal,1983,61,46312,53018,99330,87.3515
Portugal,1983,62,44985,52785,97770,85.2231
Portugal,1983,63,38007,44613,82620,85.1927
Portugal,1983,64,35130,41517,76647,84.6159
Portugal,1983,65,35995,43526,79521,82.6977
Portugal,1983,66,36313,44409,80722,81.7695
Portugal,1983,67,36171,44504,80675,81.2758
Portugal,1983,68,35736,44879,80615,79.6274
Portugal,1983,69,34229,43623,77852,78.4655
Portugal,1983,70,33015,42497,75512,77.6878
Portugal,1983,71,31517,42130,73647,74.8089
Portugal,1983,72,30546,41828,72374,73.0276
Portugal,1983,73,26996,37673,64669,71.6587
Portugal,1983,74,24170,34897,59067,69.261
Portugal,1983,75,22088,33382,55470,66.1674
Portugal,1983,76,19270,30639,49909,62.8937
Portugal,1983,77,16948,28102,45050,60.3089
Portugal,1983,78,15158,25924,41082,58.4709
Portugal,1983,79,13600,24406,38006,55.724
Portugal,1983,80,12289,22928,35217,53.5982
Portugal,1983,81,10600,19883,30483,53.3119
Portugal,1983,82,8955,17417,26372,51.4153
Portugal,1983,83,6936,14306,21242,48.4832
Portugal,1983,84,5922,12750,18672,46.4471
Portugal,1983,85,4722,10343,15065,45.6541
Portugal,1983,86,3618,8596,12214,42.0893
Portugal,1983,87,2777,6844,9621,40.5757
Portugal,1983,88,2278,5557,7835,40.9933
Portugal,1983,89,1692,4740,6432,35.6962
Portugal,1983,90,1277,3729,5006,34.2451
Portugal,1983,91,970,2705,3675,35.8595
Portugal,1983,92,608,1953,2561,31.1316
Portugal,1983,93,432,1419,1851,30.444
Portugal,1983,94,325,1016,1341,31.9882
Portugal,1983,95,155,667,822,23.2384
Portugal,1983,96,115,444,559,25.9009
Portugal,1983,97,60,291,351,20.6186
Portugal,1983,98,34,190,224,17.8947
Portugal,1983,99,21,108,129,19.4444
Portugal,1983,100,29,138,167,21.0145
Portugal,1984,0,73169,68159,141328,107.3505
Portugal,1984,1,75110,71109,146219,105.6266
Portugal,1984,2,74727,71088,145815,105.119
Portugal,1984,3,75423,72323,147746,104.2863
Portugal,1984,4,79189,75839,155028,104.4173
Portugal,1984,5,78957,75377,154334,104.7495
Portugal,1984,6,83477,80103,163580,104.2121
Portugal,1984,7,88197,84398,172595,104.5013
Portugal,1984,8,89133,85394,174527,104.3785
Portugal,1984,9,87375,84306,171681,103.6403
Portugal,1984,10,86402,83339,169741,103.6754
Portugal,1984,11,87249,84665,171914,103.052
Portugal,1984,12,86194,82958,169152,103.9008
Portugal,1984,13,86058,82547,168605,104.2533
Portugal,1984,14,84851,81503,166354,104.1078
Portugal,1984,15,83882,81430,165312,103.0112
Portugal,1984,16,83574,81241,164815,102.8717
Portugal,1984,17,84590,82434,167024,102.6154
Portugal,1984,18,84552,83234,167786,101.5835
Portugal,1984,19,84274,83975,168249,100.3561
Portugal,1984,20,82941,82172,165113,100.9358
Portugal,1984,21,81430,81380,162810,100.0614
Portugal,1984,22,80393,79972,160365,100.5264
Portugal,1984,23,79461,78799,158260,100.8401
Portugal,1984,24,75791,76233,152024,99.4202
Portugal,1984,25,74692,75069,149761,99.4978
Portugal,1984,26,73493,73926,147419,99.4143
Portugal,1984,27,69233,70207,139440,98.6127
Portugal,1984,28,69602,70769,140371,98.351
Portugal,1984,29,67758,69061,136819,98.1133
Portugal,1984,30,65152,67183,132335,96.9769
Portugal,1984,31,65330,68119,133449,95.9057
Portugal,1984,32,65179,66867,132046,97.4756
Portugal,1984,33,65304,66500,131804,98.2015
Portugal,1984,34,63735,65692,129427,97.0209
Portugal,1984,35,63319,66954,130273,94.5709
Portugal,1984,36,58660,63341,122001,92.6098
Portugal,1984,37,56258,61436,117694,91.5717
Portugal,1984,38,58004,64277,122281,90.2407
Portugal,1984,39,55182,61514,116696,89.7064
Portugal,1984,40,54458,59290,113748,91.8502
Portugal,1984,41,52145,57123,109268,91.2855
Portugal,1984,42,49922,54435,104357,91.7094
Portugal,1984,43,52822,57736,110558,91.4888
Portugal,1984,44,54698,60093,114791,91.0222
Portugal,1984,45,55339,60870,116209,90.9134
Portugal,1984,46,54787,60550,115337,90.4822
Portugal,1984,47,55615,61675,117290,90.1743
Portugal,1984,48,56335,62451,118786,90.2067
Portugal,1984,49,53991,60200,114191,89.686
Portugal,1984,50,54740,61189,115929,89.4605
Portugal,1984,51,55462,62200,117662,89.1672
Portugal,1984,52,55282,61352,116634,90.1063
Portugal,1984,53,55173,61604,116777,89.5607
Portugal,1984,54,52445,59216,111661,88.5656
Portugal,1984,55,52500,59934,112434,87.5964
Portugal,1984,56,50884,58269,109153,87.326
Portugal,1984,57,52486,60274,112760,87.079
Portugal,1984,58,51072,58782,109854,86.8837
Portugal,1984,59,50103,57340,107443,87.3788
Portugal,1984,60,47899,55232,103131,86.7233
Portugal,1984,61,46145,53195,99340,86.7469
Portugal,1984,62,45589,52510,98099,86.8197
Portugal,1984,63,44317,52430,96747,84.526
Portugal,1984,64,37370,44221,81591,84.5074
Portugal,1984,65,34305,40898,75203,83.8794
Portugal,1984,66,35088,42897,77985,81.7959
Portugal,1984,67,35308,43607,78915,80.9687
Portugal,1984,68,34996,43597,78593,80.2716
Portugal,1984,69,34545,43961,78506,78.581
Portugal,1984,70,32809,42582,75391,77.049
Portugal,1984,71,31644,41431,73075,76.3776
Portugal,1984,72,30080,40903,70983,73.5398
Portugal,1984,73,29058,40558,69616,71.6455
Portugal,1984,74,25480,36291,61771,70.2102
Portugal,1984,75,22632,33368,56000,67.8255
Portugal,1984,76,20558,31770,52328,64.7088
Portugal,1984,77,17589,29002,46591,60.6475
Portugal,1984,78,15398,26432,41830,58.2551
Portugal,1984,79,13631,24186,37817,56.3591
Portugal,1984,80,13296,24399,37695,54.494
Portugal,1984,81,11004,21052,32056,52.2706
Portugal,1984,82,9346,18097,27443,51.6439
Portugal,1984,83,7753,15596,23349,49.7115
Portugal,1984,84,5890,12721,18611,46.3014
Portugal,1984,85,4972,11106,16078,44.7686
Portugal,1984,86,3926,8913,12839,44.048
Portugal,1984,87,2955,7312,10267,40.413
Portugal,1984,88,2220,5666,7886,39.1811
Portugal,1984,89,1789,4557,6346,39.2583
Portugal,1984,90,1285,3802,5087,33.798
Portugal,1984,91,974,2934,3908,33.197
Portugal,1984,92,709,2085,2794,34.0048
Portugal,1984,93,430,1476,1906,29.1328
Portugal,1984,94,300,1080,1380,27.7778
Portugal,1984,95,219,727,946,30.1238
Portugal,1984,96,88,481,569,18.2952
Portugal,1984,97,68,305,373,22.2951
Portugal,1984,98,33,200,233,16.5
Portugal,1984,99,19,114,133,16.6667
Portugal,1984,100,22,149,171,14.7651
Portugal,1985,0,72189,67647,139836,106.7143
Portugal,1985,1,72203,67353,139556,107.2009
Portugal,1985,2,74393,70530,144923,105.4771
Portugal,1985,3,74286,70734,145020,105.0216
Portugal,1985,4,75348,72235,147583,104.3095
Portugal,1985,5,78839,75557,154396,104.3437
Portugal,1985,6,78823,75328,154151,104.6397
Portugal,1985,7,83401,80110,163511,104.1081
Portugal,1985,8,88040,84346,172386,104.3796
Portugal,1985,9,89089,85413,174502,104.3038
Portugal,1985,10,87266,84355,171621,103.4509
Portugal,1985,11,86188,83194,169382,103.5988
Portugal,1985,12,86936,84464,171400,102.9267
Portugal,1985,13,85790,82692,168482,103.7464
Portugal,1985,14,85493,82026,167519,104.2267
Portugal,1985,15,84032,80810,164842,103.9871
Portugal,1985,16,83022,80643,163665,102.95
Portugal,1985,17,82537,80423,162960,102.6286
Portugal,1985,18,83325,81401,164726,102.3636
Portugal,1985,19,83185,82118,165303,101.2993
Portugal,1985,20,82908,82884,165792,100.029
Portugal,1985,21,81553,81081,162634,100.5821
Portugal,1985,22,80079,80398,160477,99.6032
Portugal,1985,23,79148,79110,158258,100.048
Portugal,1985,24,78491,78096,156587,100.5058
Portugal,1985,25,74944,75666,150610,99.0458
Portugal,1985,26,73875,74563,148438,99.0773
Portugal,1985,27,72924,73702,146626,98.9444
Portugal,1985,28,68713,69999,138712,98.1628
Portugal,1985,29,69226,70683,139909,97.9387
Portugal,1985,30,67509,68992,136501,97.8505
Portugal,1985,31,64918,67177,132095,96.6372
Portugal,1985,32,65229,68207,133436,95.6339
Portugal,1985,33,65076,66955,132031,97.1936
Portugal,1985,34,65303,66626,131929,98.0143
Portugal,1985,35,63766,65790,129556,96.9235
Portugal,1985,36,63465,67156,130621,94.5038
Portugal,1985,37,58802,63528,122330,92.5608
Portugal,1985,38,56360,61536,117896,91.5887
Portugal,1985,39,58280,64502,122782,90.3538
Portugal,1985,40,55318,61630,116948,89.7582
Portugal,1985,41,54504,59381,113885,91.7869
Portugal,1985,42,52256,57202,109458,91.3534
Portugal,1985,43,49900,54413,104313,91.706
Portugal,1985,44,52755,57654,110409,91.5028
Portugal,1985,45,54618,60022,114640,90.9966
Portugal,1985,46,55260,60769,116029,90.9345
Portugal,1985,47,54665,60426,115091,90.466
Portugal,1985,48,55481,61586,117067,90.087
Portugal,1985,49,56277,62415,118692,90.1658
Portugal,1985,50,53771,60053,113824,89.5392
Portugal,1985,51,54477,61014,115491,89.2861
Portugal,1985,52,55248,62067,117315,89.0135
Portugal,1985,53,55049,61222,116271,89.917
Portugal,1985,54,54900,61473,116373,89.3075
Portugal,1985,55,52111,59044,111155,88.2579
Portugal,1985,56,52181,59777,111958,87.2928
Portugal,1985,57,50436,57974,108410,86.9976
Portugal,1985,58,51994,60008,112002,86.6451
Portugal,1985,59,50523,58533,109056,86.3154
Portugal,1985,60,49541,57051,106592,86.8363
Portugal,1985,61,47266,54885,102151,86.1182
Portugal,1985,62,45443,52778,98221,86.1022
Portugal,1985,63,44765,51981,96746,86.118
Portugal,1985,64,43541,51977,95518,83.7697
Portugal,1985,65,36706,43823,80529,83.7597
Portugal,1985,66,33430,40269,73699,83.0167
Portugal,1985,67,34135,42176,76311,80.9347
Portugal,1985,68,34181,42669,76850,80.1073
Portugal,1985,69,33845,42665,76510,79.3273
Portugal,1985,70,33226,42978,76204,77.3093
Portugal,1985,71,31463,41518,72981,75.7816
Portugal,1985,72,30151,40260,70411,74.8907
Portugal,1985,73,28572,39587,68159,72.1752
Portugal,1985,74,27445,39112,66557,70.1703
Portugal,1985,75,23849,34855,58704,68.4235
Portugal,1985,76,21026,31785,52811,66.1507
Portugal,1985,77,18913,30140,49053,62.7505
Portugal,1985,78,15942,27239,43181,58.5264
Portugal,1985,79,13910,24691,38601,56.3363
Portugal,1985,80,12903,23347,36250,55.2662
Portugal,1985,81,11819,22426,34245,52.7022
Portugal,1985,82,9658,19188,28846,50.3335
Portugal,1985,83,8059,16313,24372,49.4023
Portugal,1985,84,6642,13866,20508,47.9013
Portugal,1985,85,4965,11161,16126,44.4853
Portugal,1985,86,4109,9606,13715,42.7753
Portugal,1985,87,3225,7562,10787,42.6474
Portugal,1985,88,2370,6099,8469,38.8588
Portugal,1985,89,1719,4667,6386,36.8331
Portugal,1985,90,1385,3685,5070,37.5848
Portugal,1985,91,961,3027,3988,31.7476
Portugal,1985,92,731,2268,2999,32.231
Portugal,1985,93,527,1606,2133,32.8144
Portugal,1985,94,295,1101,1396,26.7938
Portugal,1985,95,217,772,989,28.1088
Portugal,1985,96,127,506,633,25.0988
Portugal,1985,97,61,319,380,19.1223
Portugal,1985,98,50,194,244,25.7732
Portugal,1985,99,24,120,144,20
Portugal,1985,100,23,158,181,14.557
Portugal,1986,0,65842,62006,127848,106.1865
Portugal,1986,1,70910,66573,137483,106.5147
Portugal,1986,2,71394,66687,138081,107.0583
Portugal,1986,3,73712,70000,143712,105.3029
Portugal,1986,4,73850,70410,144260,104.8857
Portugal,1986,5,75286,72172,147458,104.3147
Portugal,1986,6,78490,75284,153774,104.2585
Portugal,1986,7,78707,75275,153982,104.5593
Portugal,1986,8,83340,80122,163462,104.0164
Portugal,1986,9,87902,84298,172200,104.2753
Portugal,1986,10,89038,85441,174479,104.2099
Portugal,1986,11,87153,84398,171551,103.2643
Portugal,1986,12,85974,83062,169036,103.5058
Portugal,1986,13,86637,84267,170904,102.8125
Portugal,1986,14,85391,82418,167809,103.6072
Portugal,1986,15,84921,81514,166435,104.1797
Portugal,1986,16,83191,80102,163293,103.8563
Portugal,1986,17,82125,79851,161976,102.8478
Portugal,1986,18,81493,79594,161087,102.3859
Portugal,1986,19,82064,80381,162445,102.0938
Portugal,1986,20,81807,81002,162809,100.9938
Portugal,1986,21,81560,81794,163354,99.7139
Portugal,1986,22,80178,79998,160176,100.225
Portugal,1986,23,78742,79409,158151,99.16
Portugal,1986,24,77926,78250,156176,99.5859
Portugal,1986,25,77548,77392,154940,100.2016
Portugal,1986,26,74086,75111,149197,98.6354
Portugal,1986,27,73071,74047,147118,98.6819
Portugal,1986,28,72362,73467,145829,98.4959
Portugal,1986,29,68196,69779,137975,97.7314
Portugal,1986,30,68852,70605,139457,97.5172
Portugal,1986,31,67259,68931,136190,97.5744
Portugal,1986,32,64704,67176,131880,96.3201
Portugal,1986,33,65126,68297,133423,95.357
Portugal,1986,34,64961,67069,132030,96.857
Portugal,1986,35,65269,66767,132036,97.7564
Portugal,1986,36,63786,65895,129681,96.7995
Portugal,1986,37,63601,67376,130977,94.3971
Portugal,1986,38,58922,63693,122615,92.5094
Portugal,1986,39,56483,61603,118086,91.6887
Portugal,1986,40,58559,64716,123275,90.4861
Portugal,1986,41,55453,61767,117220,89.7777
Portugal,1986,42,54542,59450,113992,91.7443
Portugal,1986,43,52353,57299,109652,91.3681
Portugal,1986,44,49891,54391,104282,91.7266
Portugal,1986,45,52701,57558,110259,91.5616
Portugal,1986,46,54497,59948,114445,90.9071
Portugal,1986,47,55179,60657,115836,90.9689
Portugal,1986,48,54478,60282,114760,90.3719
Portugal,1986,49,55323,61471,116794,89.9985
Portugal,1986,50,56155,62369,118524,90.0367
Portugal,1986,51,53564,59877,113441,89.4567
Portugal,1986,52,54231,60853,115084,89.118
Portugal,1986,53,55000,61959,116959,88.7684
Portugal,1986,54,54722,61030,115752,89.6641
Portugal,1986,55,54612,61365,115977,88.9954
Portugal,1986,56,51770,58853,110623,87.9649
Portugal,1986,57,51874,59621,111495,87.0063
Portugal,1986,58,49940,57635,107575,86.6487
Portugal,1986,59,51480,59731,111211,86.1864
Portugal,1986,60,49949,58234,108183,85.7729
Portugal,1986,61,48963,56732,105695,86.3058
Portugal,1986,62,46667,54465,101132,85.6825
Portugal,1986,63,44701,52321,97022,85.4361
Portugal,1986,64,43926,51349,95275,85.544
Portugal,1986,65,42710,51525,94235,82.8918
Portugal,1986,66,35948,43364,79312,82.8983
Portugal,1986,67,32542,39612,72154,82.1519
Portugal,1986,68,33204,41450,74654,80.1062
Portugal,1986,69,33024,41763,74787,79.0748
Portugal,1986,70,32515,41670,74185,78.0298
Portugal,1986,71,31849,41896,73745,76.0192
Portugal,1986,72,29995,40395,70390,74.2542
Portugal,1986,73,28640,39034,67674,73.3719
Portugal,1986,74,26998,38175,65173,70.7217
Portugal,1986,75,25780,37561,63341,68.635
Portugal,1986,76,22244,33280,55524,66.8389
Portugal,1986,77,19378,30062,49440,64.4601
Portugal,1986,78,17270,28395,45665,60.8206
Portugal,1986,79,14220,25454,39674,55.8655
Portugal,1986,80,13725,24522,38247,55.9701
Portugal,1986,81,11540,21567,33107,53.5077
Portugal,1986,82,10437,20458,30895,51.0167
Portugal,1986,83,8411,17368,25779,48.4281
Portugal,1986,84,6935,14606,21541,47.4805
Portugal,1986,85,5599,12172,17771,45.999
Portugal,1986,86,4084,9629,13713,42.4135
Portugal,1986,87,3328,8217,11545,40.5014
Portugal,1986,88,2585,6331,8916,40.8308
Portugal,1986,89,1844,5027,6871,36.6819
Portugal,1986,90,1299,3763,5062,34.5203
Portugal,1986,91,1026,2929,3955,35.029
Portugal,1986,92,726,2314,3040,31.3742
Portugal,1986,93,515,1732,2247,29.7344
Portugal,1986,94,357,1189,1546,30.0252
Portugal,1986,95,207,796,1003,26.005
Portugal,1986,96,151,553,704,27.3056
Portugal,1986,97,76,358,434,21.2291
Portugal,1986,98,40,214,254,18.6916
Portugal,1986,99,27,127,154,21.2598
Portugal,1986,100,28,167,195,16.7665
Portugal,1987,0,63854,60099,123953,106.248
Portugal,1987,1,64917,61206,126123,106.0631
Portugal,1987,2,69801,65608,135409,106.391
Portugal,1987,3,70628,66043,136671,106.9424
Portugal,1987,4,73056,69467,142523,105.1665
Portugal,1987,5,73426,70082,143508,104.7716
Portugal,1987,6,75241,72097,147338,104.3608
Portugal,1987,7,78133,75011,153144,104.1621
Portugal,1987,8,78594,75220,153814,104.4855
Portugal,1987,9,83273,80138,163411,103.912
Portugal,1987,10,87783,84249,172032,104.1947
Portugal,1987,11,88989,85467,174456,104.1209
Portugal,1987,12,87060,84445,171505,103.0967
Portugal,1987,13,85755,82931,168686,103.4052
Portugal,1987,14,86326,84064,170390,102.6908
Portugal,1987,15,84978,82143,167121,103.4513
Portugal,1987,16,84343,80981,165324,104.1516
Portugal,1987,17,82322,79407,161729,103.671
Portugal,1987,18,81206,79075,160281,102.6949
Portugal,1987,19,80416,78753,159169,102.1117
Portugal,1987,20,80821,79362,160183,101.8384
Portugal,1987,21,80433,79896,160329,100.6721
Portugal,1987,22,80224,80712,160936,99.3954
Portugal,1987,23,78809,78910,157719,99.872
Portugal,1987,24,77437,78422,155859,98.744
Portugal,1987,25,76721,77398,154119,99.1253
Portugal,1987,26,76605,76685,153290,99.8957
Portugal,1987,27,73248,74554,147802,98.2482
Portugal,1987,28,72261,73540,145801,98.2608
Portugal,1987,29,71794,73234,145028,98.0337
Portugal,1987,30,67682,69563,137245,97.296
Portugal,1987,31,68469,70516,138985,97.0971
Portugal,1987,32,67015,68858,135873,97.3235
Portugal,1987,33,64479,67173,131652,95.9895
Portugal,1987,34,65020,68402,133422,95.0557
Portugal,1987,35,64860,67163,132023,96.571
Portugal,1987,36,65233,66906,132139,97.4995
Portugal,1987,37,63809,66003,129812,96.6759
Portugal,1987,38,63745,67582,131327,94.3225
Portugal,1987,39,59035,63850,122885,92.4589
Portugal,1987,40,56572,61693,118265,91.6992
Portugal,1987,41,58805,64919,123724,90.5821
Portugal,1987,42,55567,61894,117461,89.7777
Portugal,1987,43,54584,59536,114120,91.6823
Portugal,1987,44,52433,57385,109818,91.3706
Portugal,1987,45,49847,54378,104225,91.6676
Portugal,1987,46,52601,57463,110064,91.5389
Portugal,1987,47,54370,59858,114228,90.8316
Portugal,1987,48,55038,60546,115584,90.9028
Portugal,1987,49,54275,60140,114415,90.2478
Portugal,1987,50,55144,61355,116499,89.8769
Portugal,1987,51,56027,62305,118332,89.9238
Portugal,1987,52,53316,59735,113051,89.2542
Portugal,1987,53,53951,60636,114587,88.9752
Portugal,1987,54,54747,61829,116576,88.5458
Portugal,1987,55,54385,60864,115249,89.355
Portugal,1987,56,54265,61194,115459,88.677
Portugal,1987,57,51360,58614,109974,87.6241
Portugal,1987,58,51499,59403,110902,86.6943
Portugal,1987,59,49409,57287,106696,86.2482
Portugal,1987,60,50924,59389,110313,85.7465
Portugal,1987,61,49349,57941,107290,85.1711
Portugal,1987,62,48352,56357,104709,85.7959
Portugal,1987,63,45988,54059,100047,85.07
Portugal,1987,64,43928,51805,95733,84.7949
Portugal,1987,65,43013,50734,93747,84.7814
Portugal,1987,66,41838,51027,92865,81.9919
Portugal,1987,67,35160,42911,78071,81.937
Portugal,1987,68,31589,38890,70479,81.2265
Portugal,1987,69,32143,40654,72797,79.0648
Portugal,1987,70,31802,40780,72582,77.9843
Portugal,1987,71,31146,40596,71742,76.7218
Portugal,1987,72,30476,40739,71215,74.8079
Portugal,1987,73,28587,39163,67750,72.9949
Portugal,1987,74,27128,37726,64854,71.908
Portugal,1987,75,25393,36707,62100,69.1775
Portugal,1987,76,24186,35951,60137,67.2749
Portugal,1987,77,20667,31654,52321,65.2903
Portugal,1987,78,17794,28310,46104,62.8541
Portugal,1987,79,15829,26584,42413,59.5433
Portugal,1987,80,14279,25643,39922,55.6838
Portugal,1987,81,12273,22654,34927,54.1759
Portugal,1987,82,10216,19821,30037,51.5413
Portugal,1987,83,9168,18571,27739,49.3673
Portugal,1987,84,7293,15578,22871,46.816
Portugal,1987,85,5932,12920,18852,45.9133
Portugal,1987,86,4650,10585,15235,43.9301
Portugal,1987,87,3375,8312,11687,40.6039
Portugal,1987,88,2691,6872,9563,39.1589
Portugal,1987,89,2062,5257,7319,39.2239
Portugal,1987,90,1414,4135,5549,34.1959
Portugal,1987,91,989,2986,3975,33.1212
Portugal,1987,92,787,2285,3072,34.442
Portugal,1987,93,517,1774,2291,29.1432
Portugal,1987,94,382,1344,1726,28.4226
Portugal,1987,95,243,889,1132,27.3341
Portugal,1987,96,132,549,681,24.0437
Portugal,1987,97,99,417,516,23.741
Portugal,1987,98,45,242,287,18.595
Portugal,1987,99,26,143,169,18.1818
Portugal,1987,100,36,189,225,19.0476
Portugal,1988,0,62012,58365,120377,106.2486
Portugal,1988,1,62516,58982,121498,105.9917
Portugal,1988,2,64123,60510,124633,105.9709
Portugal,1988,3,68743,64669,133412,106.2998
Portugal,1988,4,69874,65419,135293,106.8099
Portugal,1988,5,72393,68944,141337,105.0026
Portugal,1988,6,73009,69760,142769,104.6574
Portugal,1988,7,75197,72033,147230,104.3924
Portugal,1988,8,77801,74738,152539,104.0983
Portugal,1988,9,78484,75168,153652,104.4115
Portugal,1988,10,83206,80158,163364,103.8025
Portugal,1988,11,87650,84199,171849,104.0986
Portugal,1988,12,88950,85481,174431,104.0582
Portugal,1988,13,86947,84500,171447,102.8959
Portugal,1988,14,85543,82792,168335,103.3228
Portugal,1988,15,86004,83858,169862,102.5591
Portugal,1988,16,84539,81852,166391,103.2828
Portugal,1988,17,83744,80459,164203,104.0828
Portugal,1988,18,81428,78716,160144,103.4453
Portugal,1988,19,80265,78294,158559,102.5174
Portugal,1988,20,79347,77918,157265,101.834
Portugal,1988,21,79546,78341,157887,101.5381
Portugal,1988,22,79058,78785,157843,100.3465
Portugal,1988,23,78848,79634,158482,99.013
Portugal,1988,24,77454,77831,155285,99.5156
Portugal,1988,25,76122,77430,153552,98.3107
Portugal,1988,26,75480,76538,152018,98.6177
Portugal,1988,27,75650,75983,151633,99.5617
Portugal,1988,28,72387,73985,146372,97.8401
Portugal,1988,29,71443,73034,144477,97.8216
Portugal,1988,30,71211,73004,144215,97.544
Portugal,1988,31,67175,69346,136521,96.8693
Portugal,1988,32,68077,70428,138505,96.6618
Portugal,1988,33,66769,68781,135550,97.0748
Portugal,1988,34,64228,67166,131394,95.6258
Portugal,1988,35,64903,68500,133403,94.7489
Portugal,1988,36,64747,67250,131997,96.2781
Portugal,1988,37,65194,67024,132218,97.2696
Portugal,1988,38,63792,66091,129883,96.5215
Portugal,1988,39,63896,67778,131674,94.2725
Portugal,1988,40,59131,64011,123142,92.3763
Portugal,1988,41,56657,61758,118415,91.7403
Portugal,1988,42,59055,65120,124175,90.6864
Portugal,1988,43,55701,62007,117708,89.8302
Portugal,1988,44,54618,59605,114223,91.6333
Portugal,1988,45,52523,57458,109981,91.4111
Portugal,1988,46,49823,54341,104164,91.6858
Portugal,1988,47,52494,57347,109841,91.5375
Portugal,1988,48,54211,59751,113962,90.7282
Portugal,1988,49,54908,60418,115326,90.8802
Portugal,1988,50,54078,59986,114064,90.151
Portugal,1988,51,54954,61216,116170,89.7706
Portugal,1988,52,55902,62239,118141,89.8183
Portugal,1988,53,53073,59555,112628,89.1159
Portugal,1988,54,53577,60438,114015,88.6479
Portugal,1988,55,54481,61690,116171,88.3142
Portugal,1988,56,54043,60660,114703,89.0917
Portugal,1988,57,53910,61038,114948,88.322
Portugal,1988,58,50950,58385,109335,87.2656
Portugal,1988,59,51117,59213,110330,86.3273
Portugal,1988,60,48821,56951,105772,85.7246
Portugal,1988,61,50352,59025,109377,85.3062
Portugal,1988,62,48775,57612,106387,84.6612
Portugal,1988,63,47667,55968,103635,85.1683
Portugal,1988,64,45215,53627,98842,84.3139
Portugal,1988,65,43136,51273,94409,84.13
Portugal,1988,66,42084,50075,92159,84.0419
Portugal,1988,67,40995,50489,91484,81.1959
Portugal,1988,68,34349,42404,76753,81.0042
Portugal,1988,69,30626,38150,68776,80.2779
Portugal,1988,70,31023,39767,70790,78.0119
Portugal,1988,71,30550,39759,70309,76.8379
Portugal,1988,72,29862,39474,69336,75.6498
Portugal,1988,73,29063,39552,68615,73.4805
Portugal,1988,74,27089,37904,64993,71.4674
Portugal,1988,75,25581,36320,61901,70.4323
Portugal,1988,76,23715,35184,58899,67.4028
Portugal,1988,77,22496,34367,56863,65.4581
Portugal,1988,78,19038,29932,48970,63.6042
Portugal,1988,79,16190,26537,42727,61.0092
Portugal,1988,80,15129,26236,41365,57.665
Portugal,1988,81,12860,23731,36591,54.1907
Portugal,1988,82,10952,20700,31652,52.9082
Portugal,1988,83,8962,18084,27046,49.5576
Portugal,1988,84,7935,16618,24553,47.7494
Portugal,1988,85,6271,13814,20085,45.396
Portugal,1988,86,4997,11343,16340,44.0536
Portugal,1988,87,3848,9174,13022,41.9446
Portugal,1988,88,2777,6983,9760,39.768
Portugal,1988,89,2177,5716,7893,38.0861
Portugal,1988,90,1597,4282,5879,37.2957
Portugal,1988,91,1108,3370,4478,32.8783
Portugal,1988,92,755,2348,3103,32.155
Portugal,1988,93,582,1755,2337,33.1624
Portugal,1988,94,361,1341,1702,26.9202
Portugal,1988,95,271,1017,1288,26.647
Portugal,1988,96,168,652,820,25.7669
Portugal,1988,97,83,388,471,21.3918
Portugal,1988,98,68,288,356,23.6111
Portugal,1988,99,32,164,196,19.5122
Portugal,1988,100,35,208,243,16.8269
Portugal,1989,0,61193,57630,118823,106.1825
Portugal,1989,1,60438,56963,117401,106.1005
Portugal,1989,2,61263,57919,119182,105.7736
Portugal,1989,3,63345,59852,123197,105.8361
Portugal,1989,4,67692,63744,131436,106.1935
Portugal,1989,5,69134,64807,133941,106.6767
Portugal,1989,6,71755,68429,140184,104.8605
Portugal,1989,7,72593,69457,142050,104.515
Portugal,1989,8,75153,71974,147127,104.4169
Portugal,1989,9,77461,74478,151939,104.0052
Portugal,1989,10,78375,75123,153498,104.3289
Portugal,1989,11,83136,80176,163312,103.6919
Portugal,1989,12,87511,84148,171659,103.9965
Portugal,1989,13,88902,85503,174405,103.9753
Portugal,1989,14,86833,84539,171372,102.7135
Portugal,1989,15,85310,82650,167960,103.2184
Portugal,1989,16,85655,83654,169309,102.392
Portugal,1989,17,84069,81584,165653,103.0459
Portugal,1989,18,83092,79928,163020,103.9586
Portugal,1989,19,80537,78014,158551,103.234
Portugal,1989,20,79305,77515,156820,102.3092
Portugal,1989,21,78263,77090,155353,101.5216
Portugal,1989,22,78289,77321,155610,101.2519
Portugal,1989,23,77696,77679,155375,100.0219
Portugal,1989,24,77480,78555,156035,98.6315
Portugal,1989,25,76084,76749,152833,99.1335
Portugal,1989,26,74829,76442,151271,97.8899
Portugal,1989,27,74232,75678,149910,98.0893
Portugal,1989,28,74694,75268,149962,99.2374
Portugal,1989,29,71530,73420,144950,97.4258
Portugal,1989,30,70619,72517,143136,97.3827
Portugal,1989,31,70615,72761,143376,97.0506
Portugal,1989,32,66659,69126,135785,96.4312
Portugal,1989,33,67674,70338,138012,96.2126
Portugal,1989,34,66504,68719,135223,96.7767
Portugal,1989,35,63970,67161,131131,95.2487
Portugal,1989,36,64766,68604,133370,94.4056
Portugal,1989,37,64640,67356,131996,95.9677
Portugal,1989,38,65138,67137,132275,97.0225
Portugal,1989,39,63778,66178,129956,96.3734
Portugal,1989,40,64002,67975,131977,94.1552
Portugal,1989,41,59232,64182,123414,92.2876
Portugal,1989,42,56700,61827,118527,91.7075
Portugal,1989,43,59279,65337,124616,90.7281
Portugal,1989,44,55790,62116,117906,89.8158
Portugal,1989,45,54635,59686,114321,91.5374
Portugal,1989,46,52598,57510,110108,91.4589
Portugal,1989,47,49777,54255,104032,91.7464
Portugal,1989,48,52382,57227,109609,91.5337
Portugal,1989,49,54043,59632,113675,90.6275
Portugal,1989,50,54746,60283,115029,90.815
Portugal,1989,51,53836,59803,113639,90.0222
Portugal,1989,52,54745,61086,115831,89.6196
Portugal,1989,53,55748,62139,117887,89.715
Portugal,1989,54,52771,59395,112166,88.8475
Portugal,1989,55,53196,60194,113390,88.3743
Portugal,1989,56,54124,61555,115679,87.9279
Portugal,1989,57,53713,60456,114169,88.8464
Portugal,1989,58,53496,60861,114357,87.8987
Portugal,1989,59,50500,58157,108657,86.8339
Portugal,1989,60,50669,58980,109649,85.9088
Portugal,1989,61,48155,56583,104738,85.1051
Portugal,1989,62,49684,58642,108326,84.7243
Portugal,1989,63,48111,57248,105359,84.0396
Portugal,1989,64,46931,55511,102442,84.5436
Portugal,1989,65,44411,53156,97567,83.5484
Portugal,1989,66,42227,50654,92881,83.3636
Portugal,1989,67,41009,49290,90299,83.1994
Portugal,1989,68,39985,49878,89863,80.1656
Portugal,1989,69,33453,41842,75295,79.9508
Portugal,1989,70,29618,37283,66901,79.441
Portugal,1989,71,29865,38868,68733,76.837
Portugal,1989,72,29206,38640,67846,75.5849
Portugal,1989,73,28486,38257,66743,74.4596
Portugal,1989,74,27591,38323,65914,71.9959
Portugal,1989,75,25509,36449,61958,69.9855
Portugal,1989,76,23970,34780,58750,68.9189
Portugal,1989,77,22084,33438,55522,66.0446
Portugal,1989,78,20765,32554,53319,63.7863
Portugal,1989,79,17378,28121,45499,61.7972
Portugal,1989,80,16023,27220,43243,58.8648
Portugal,1989,81,13530,24385,37915,55.4849
Portugal,1989,82,11386,21834,33220,52.148
Portugal,1989,83,9584,18824,28408,50.9137
Portugal,1989,84,7732,16178,23910,47.7933
Portugal,1989,85,6793,14759,21552,46.0262
Portugal,1989,86,5258,12102,17360,43.4474
Portugal,1989,87,4163,9698,13861,42.9264
Portugal,1989,88,3099,7800,10899,39.7308
Portugal,1989,89,2201,5844,8045,37.6626
Portugal,1989,90,1683,4662,6345,36.1004
Portugal,1989,91,1187,3461,4648,34.2964
Portugal,1989,92,841,2666,3507,31.5454
Portugal,1989,93,576,1806,2382,31.8937
Portugal,1989,94,406,1311,1717,30.9687
Portugal,1989,95,252,974,1226,25.8727
Portugal,1989,96,173,731,904,23.6662
Portugal,1989,97,111,461,572,24.0781
Portugal,1989,98,51,254,305,20.0787
Portugal,1989,99,41,180,221,22.7778
Portugal,1989,100,42,229,271,18.3406
Portugal,1990,0,59542,56539,116081,105.3114
Portugal,1990,1,58890,55750,114640,105.6323
Portugal,1990,2,58980,55662,114642,105.961
Portugal,1990,3,60039,56893,116932,105.5297
Portugal,1990,4,62580,59193,121773,105.722
Portugal,1990,5,66645,62840,129485,106.0551
Portugal,1990,6,68399,64193,132592,106.5521
Portugal,1990,7,71117,67917,139034,104.7116
Portugal,1990,8,72177,69143,141320,104.388
Portugal,1990,9,75120,71918,147038,104.4523
Portugal,1990,10,77122,74209,151331,103.9254
Portugal,1990,11,78263,75080,153343,104.2395
Portugal,1990,12,83072,80192,163264,103.5914
Portugal,1990,13,87379,84099,171478,103.9002
Portugal,1990,14,88847,85517,174364,103.894
Portugal,1990,15,86706,84583,171289,102.51
Portugal,1990,16,85064,82512,167576,103.0929
Portugal,1990,17,85287,83452,168739,102.1989
Portugal,1990,18,83596,81302,164898,102.8216
Portugal,1990,19,82456,79411,161867,103.8345
Portugal,1990,20,79629,77306,156935,103.0049
Portugal,1990,21,78372,76734,155106,102.1346
Portugal,1990,22,77189,76260,153449,101.2182
Portugal,1990,23,77020,76304,153324,100.9384
Portugal,1990,24,76337,76564,152901,99.7035
Portugal,1990,25,76107,77468,153575,98.2431
Portugal,1990,26,74689,75677,150366,98.6945
Portugal,1990,27,73517,75447,148964,97.4419
Portugal,1990,28,72992,74824,147816,97.5516
Portugal,1990,29,73722,74560,148282,98.8761
Portugal,1990,30,70660,72848,143508,96.9965
Portugal,1990,31,69789,72002,141791,96.9265
Portugal,1990,32,70004,72512,142516,96.5413
Portugal,1990,33,66127,68913,135040,95.9572
Portugal,1990,34,67283,70258,137541,95.7656
Portugal,1990,35,66244,68649,134893,96.4967
Portugal,1990,36,63711,67140,130851,94.8928
Portugal,1990,37,64651,68690,133341,94.12
Portugal,1990,38,64519,67426,131945,95.6886
Portugal,1990,39,65107,67251,132358,96.8119
Portugal,1990,40,63766,66259,130025,96.2375
Portugal,1990,41,64102,68171,132273,94.0312
Portugal,1990,42,59331,64329,123660,92.2306
Portugal,1990,43,56764,61889,118653,91.719
Portugal,1990,44,59495,65512,125007,90.8154
Portugal,1990,45,55885,62201,118086,89.8458
Portugal,1990,46,54659,59739,114398,91.4963
Portugal,1990,47,52658,57566,110224,91.4741
Portugal,1990,48,49697,54196,103893,91.6986
Portugal,1990,49,52253,57090,109343,91.5274
Portugal,1990,50,53879,59503,113382,90.5484
Portugal,1990,51,54553,60146,114699,90.701
Portugal,1990,52,53629,59646,113275,89.9121
Portugal,1990,53,54554,60965,115519,89.4841
Portugal,1990,54,55526,62083,117609,89.4383
Portugal,1990,55,52484,59245,111729,88.5881
Portugal,1990,56,52815,59966,112781,88.0749
Portugal,1990,57,53749,61373,115122,87.5776
Portugal,1990,58,53348,60232,113580,88.5709
Portugal,1990,59,53082,60676,113758,87.4843
Portugal,1990,60,50056,57919,107975,86.4241
Portugal,1990,61,50194,58736,108930,85.457
Portugal,1990,62,47469,56196,103665,84.4704
Portugal,1990,63,49024,58245,107269,84.1686
Portugal,1990,64,47417,56835,104252,83.4292
Portugal,1990,65,46138,55073,101211,83.7761
Portugal,1990,66,43586,52660,96246,82.7687
Portugal,1990,67,41325,50065,91390,82.5427
Portugal,1990,68,39917,48556,88473,82.2082
Portugal,1990,69,38948,49217,88165,79.1353
Portugal,1990,70,32569,41247,73816,78.9609
Portugal,1990,71,28492,36461,64953,78.1438
Portugal,1990,72,28729,37921,66650,75.7601
Portugal,1990,73,27854,37485,65339,74.3071
Portugal,1990,74,27020,36936,63956,73.1536
Portugal,1990,75,26129,36910,63039,70.7911
Portugal,1990,76,23988,34959,58947,68.6175
Portugal,1990,77,22328,33229,55557,67.1943
Portugal,1990,78,20447,31634,52081,64.6362
Portugal,1990,79,19061,30704,49765,62.0799
Portugal,1990,80,16440,27523,43963,59.7319
Portugal,1990,81,14433,25261,39694,57.1355
Portugal,1990,82,12087,22464,34551,53.8061
Portugal,1990,83,10014,19864,29878,50.4128
Portugal,1990,84,8286,17050,25336,48.5982
Portugal,1990,85,6638,14390,21028,46.1293
Portugal,1990,86,5743,12965,18708,44.2962
Portugal,1990,87,4375,10507,14882,41.6389
Portugal,1990,88,3400,8379,11779,40.5776
Portugal,1990,89,2493,6569,9062,37.951
Portugal,1990,90,1727,4754,6481,36.3273
Portugal,1990,91,1308,3769,5077,34.7042
Portugal,1990,92,901,2771,3672,32.5153
Portugal,1990,93,635,2040,2675,31.1275
Portugal,1990,94,423,1382,1805,30.6078
Portugal,1990,95,296,955,1251,30.9948
Portugal,1990,96,181,698,879,25.9312
Portugal,1990,97,118,531,649,22.2222
Portugal,1990,98,72,296,368,24.3243
Portugal,1990,99,35,174,209,20.1149
Portugal,1990,100,50,247,297,20.2429
Portugal,1991,0,58122,55064,113186,105.5535
Portugal,1991,1,58061,55224,113285,105.1373
Portugal,1991,2,56704,53958,110662,105.0891
Portugal,1991,3,57533,54389,111922,105.7806
Portugal,1991,4,58836,55881,114717,105.288
Portugal,1991,5,61842,58555,120397,105.6135
Portugal,1991,6,65610,61930,127540,105.9422
Portugal,1991,7,67664,63583,131247,106.4184
Portugal,1991,8,70481,67402,137883,104.5681
Portugal,1991,9,71772,68830,140602,104.2743
Portugal,1991,10,75079,71859,146938,104.481
Portugal,1991,11,76790,73945,150735,103.8475
Portugal,1991,12,78155,75036,153191,104.1567
Portugal,1991,13,82998,80206,163204,103.481
Portugal,1991,14,87241,84034,171275,103.8163
Portugal,1991,15,88773,85526,174299,103.7965
Portugal,1991,16,86561,84617,171178,102.2974
Portugal,1991,17,84775,82369,167144,102.921
Portugal,1991,18,84893,83242,168135,101.9834
Portugal,1991,19,83077,81014,164091,102.5465
Portugal,1991,20,81775,78886,160661,103.6622
Portugal,1991,21,78719,76615,155334,102.7462
Portugal,1991,22,77444,75950,153394,101.9671
Portugal,1991,23,76117,75423,151540,100.9201
Portugal,1991,24,75733,75278,151011,100.6044
Portugal,1991,25,74990,75453,150443,99.3864
Portugal,1991,26,74743,76387,151130,97.8478
Portugal,1991,27,73336,74577,147913,98.3359
Portugal,1991,28,72212,74455,146667,96.9874
Portugal,1991,29,71749,73958,145707,97.0132
Portugal,1991,30,72742,73847,146589,98.5037
Portugal,1991,31,69793,72278,142071,96.5619
Portugal,1991,32,68953,71489,140442,96.4526
Portugal,1991,33,69410,72256,141666,96.0612
Portugal,1991,34,65603,68680,134283,95.5198
Portugal,1991,35,66878,70163,137041,95.318
Portugal,1991,36,65932,68571,134503,96.1514
Portugal,1991,37,63455,67109,130564,94.5551
Portugal,1991,38,64516,68783,133299,93.7964
Portugal,1991,39,64358,67493,131851,95.3551
Portugal,1991,40,65043,67353,132396,96.5703
Portugal,1991,41,63729,66330,130059,96.0787
Portugal,1991,42,64188,68360,132548,93.897
Portugal,1991,43,59399,64501,123900,92.09
Portugal,1991,44,56780,61943,118723,91.6649
Portugal,1991,45,59676,65686,125362,90.8504
Portugal,1991,46,55966,62287,118253,89.8518
Portugal,1991,47,54639,59791,114430,91.3833
Portugal,1991,48,52696,57620,110316,91.4544
Portugal,1991,49,49589,54109,103698,91.6465
Portugal,1991,50,52086,56951,109037,91.4576
Portugal,1991,51,53679,59358,113037,90.4326
Portugal,1991,52,54391,59981,114372,90.6804
Portugal,1991,53,53348,59446,112794,89.742
Portugal,1991,54,54241,60812,115053,89.1946
Portugal,1991,55,55301,61979,117280,89.2254
Portugal,1991,56,52190,59003,111193,88.4531
Portugal,1991,57,52315,59696,112011,87.6357
Portugal,1991,58,53307,61157,114464,87.1642
Portugal,1991,59,52857,59980,112837,88.1244
Portugal,1991,60,52635,60468,113103,87.046
Portugal,1991,61,49519,57624,107143,85.9347
Portugal,1991,62,49643,58470,108113,84.9034
Portugal,1991,63,46714,55756,102470,83.7829
Portugal,1991,64,48203,57797,106000,83.4005
Portugal,1991,65,46542,56345,102887,82.6018
Portugal,1991,66,45215,54484,99699,82.9877
Portugal,1991,67,42688,52059,94747,81.9993
Portugal,1991,68,40237,49346,89583,81.5406
Portugal,1991,69,38783,47675,86458,81.3487
Portugal,1991,70,37798,48485,86283,77.9581
Portugal,1991,71,31524,40500,72024,77.837
Portugal,1991,72,27311,35501,62812,76.9302
Portugal,1991,73,27443,36767,64210,74.6403
Portugal,1991,74,26334,36173,62507,72.8002
Portugal,1991,75,25430,35409,60839,71.8179
Portugal,1991,76,24502,35378,59880,69.2577
Portugal,1991,77,22354,33299,55653,67.1311
Portugal,1991,78,20607,31376,51983,65.6776
Portugal,1991,79,18681,29629,48310,63.0497
Portugal,1991,80,17740,29451,47191,60.2356
Portugal,1991,81,14786,25505,40291,57.9729
Portugal,1991,82,12794,23213,36007,55.1157
Portugal,1991,83,10586,20345,30931,52.0324
Portugal,1991,84,8654,17786,26440,48.6562
Portugal,1991,85,7058,14989,22047,47.0879
Portugal,1991,86,5555,12475,18030,44.5291
Portugal,1991,87,4717,11141,15858,42.3391
Portugal,1991,88,3504,8928,12432,39.2473
Portugal,1991,89,2688,6892,9580,39.0017
Portugal,1991,90,1949,5325,7274,36.6009
Portugal,1991,91,1282,3749,5031,34.1958
Portugal,1991,92,952,2921,3873,32.5916
Portugal,1991,93,636,2088,2724,30.4598
Portugal,1991,94,465,1506,1971,30.8765
Portugal,1991,95,278,1001,1279,27.7722
Portugal,1991,96,199,652,851,30.5215
Portugal,1991,97,107,488,595,21.9262
Portugal,1991,98,81,343,424,23.6152
Portugal,1991,99,41,193,234,21.2435
Portugal,1991,100,49,246,295,19.9187
Portugal,1992,0,58805,55490,114295,105.974
Portugal,1992,1,55563,53108,108671,104.6227
Portugal,1992,2,56672,53986,110658,104.9754
Portugal,1992,3,54524,52172,106696,104.5082
Portugal,1992,4,56098,53118,109216,105.6102
Portugal,1992,5,57629,54862,112491,105.0436
Portugal,1992,6,61097,57919,119016,105.487
Portugal,1992,7,64565,61019,125584,105.8113
Portugal,1992,8,66927,62972,129899,106.2806
Portugal,1992,9,69836,66895,136731,104.3964
Portugal,1992,10,71367,68516,139883,104.1611
Portugal,1992,11,75030,71807,146837,104.4884
Portugal,1992,12,76451,73678,150129,103.7637
Portugal,1992,13,78047,74987,153034,104.0807
Portugal,1992,14,82914,80212,163126,103.3686
Portugal,1992,15,87086,83974,171060,103.7059
Portugal,1992,16,88663,85534,174197,103.6582
Portugal,1992,17,86391,84650,171041,102.0567
Portugal,1992,18,84421,82221,166642,102.6757
Portugal,1992,19,84484,83030,167514,101.7512
Portugal,1992,20,82539,80721,163260,102.2522
Portugal,1992,21,81113,78360,159473,103.5133
Portugal,1992,22,77815,75915,153730,102.5028
Portugal,1992,23,76511,75175,151686,101.7772
Portugal,1992,24,75035,74594,149629,100.5912
Portugal,1992,25,74459,74255,148714,100.2747
Portugal,1992,26,73617,74339,147956,99.0288
Portugal,1992,27,73365,75295,148660,97.4367
Portugal,1992,28,71956,73495,145451,97.906
Portugal,1992,29,70901,73446,144347,96.5349
Portugal,1992,30,70484,73097,143581,96.4253
Portugal,1992,31,71753,73130,144883,98.1171
Portugal,1992,32,68890,71711,140601,96.0662
Portugal,1992,33,68090,70960,139050,95.9555
Portugal,1992,34,68799,72008,140807,95.5436
Portugal,1992,35,65073,68457,133530,95.0568
Portugal,1992,36,66437,70065,136502,94.822
Portugal,1992,37,65655,68486,134141,95.8663
Portugal,1992,38,63166,67078,130244,94.168
Portugal,1992,39,64349,68868,133217,93.4382
Portugal,1992,40,64193,67558,131751,95.0191
Portugal,1992,41,64954,67454,132408,96.2938
Portugal,1992,42,63685,66395,130080,95.9184
Portugal,1992,43,64243,68530,132773,93.7443
Portugal,1992,44,59473,64643,124116,92.0022
Portugal,1992,45,56779,61961,118740,91.6367
Portugal,1992,46,59859,65836,125695,90.9214
Portugal,1992,47,56013,62360,118373,89.822
Portugal,1992,48,54582,59848,114430,91.201
Portugal,1992,49,52704,57682,110386,91.3699
Portugal,1992,50,49428,54019,103447,91.5011
Portugal,1992,51,51907,56795,108702,91.3936
Portugal,1992,52,53442,59208,112650,90.2615
Portugal,1992,53,54165,59801,113966,90.5754
Portugal,1992,54,53046,59232,112278,89.5563
Portugal,1992,55,53927,60622,114549,88.9562
Portugal,1992,56,55011,61846,116857,88.9484
Portugal,1992,57,51850,58757,110607,88.2448
Portugal,1992,58,51827,59387,111214,87.2699
Portugal,1992,59,52801,60927,113728,86.6627
Portugal,1992,60,52325,59709,112034,87.6334
Portugal,1992,61,52069,60193,112262,86.5034
Portugal,1992,62,48881,57254,106135,85.3757
Portugal,1992,63,49003,58119,107122,84.3149
Portugal,1992,64,45882,55239,101121,83.0609
Portugal,1992,65,47298,57303,104601,82.5402
Portugal,1992,66,45604,55804,101408,81.7217
Portugal,1992,67,44256,53856,98112,82.1747
Portugal,1992,68,41653,51416,93069,81.0117
Portugal,1992,69,39100,48598,87698,80.456
Portugal,1992,70,37498,46737,84235,80.2319
Portugal,1992,71,36558,47614,84172,76.7799
Portugal,1992,72,30381,39753,70134,76.4244
Portugal,1992,73,26046,34431,60477,75.6469
Portugal,1992,74,26058,35515,61573,73.3718
Portugal,1992,75,24781,34814,59595,71.1811
Portugal,1992,76,23789,33780,57569,70.4233
Portugal,1992,77,22796,33715,56511,67.6138
Portugal,1992,78,20704,31476,52180,65.7771
Portugal,1992,79,18837,29431,48268,64.0039
Portugal,1992,80,17904,29446,47350,60.8028
Portugal,1992,81,15925,27295,43220,58.344
Portugal,1992,82,13175,23500,36675,56.0638
Portugal,1992,83,11238,21068,32306,53.3416
Portugal,1992,84,9220,18216,27436,50.6148
Portugal,1992,85,7422,15761,23183,47.0909
Portugal,1992,86,5871,13056,18927,44.9678
Portugal,1992,87,4624,10749,15373,43.018
Portugal,1992,88,3810,9400,13210,40.5319
Portugal,1992,89,2791,7441,10232,37.5084
Portugal,1992,90,2105,5607,7712,37.5424
Portugal,1992,91,1450,4258,5708,34.0535
Portugal,1992,92,943,2910,3853,32.4055
Portugal,1992,93,686,2190,2876,31.3242
Portugal,1992,94,474,1605,2079,29.5327
Portugal,1992,95,345,1121,1466,30.7761
Portugal,1992,96,181,722,903,25.0693
Portugal,1992,97,129,458,587,28.1659
Portugal,1992,98,61,314,375,19.4268
Portugal,1992,99,47,226,273,20.7965
Portugal,1992,100,54,260,314,20.7692
Portugal,1993,0,57972,55304,113276,104.8242
Portugal,1993,1,58406,55077,113483,106.0443
Portugal,1993,2,55453,53000,108453,104.6283
Portugal,1993,3,56396,53754,110150,104.915
Portugal,1993,4,54708,52286,106994,104.6322
Portugal,1993,5,56122,53167,109289,105.558
Portugal,1993,6,57708,54969,112677,104.9828
Portugal,1993,7,61032,57855,118887,105.4913
Portugal,1993,8,64635,61125,125760,105.7423
Portugal,1993,9,66931,63038,129969,106.1756
Portugal,1993,10,69796,66926,136722,104.2883
Portugal,1993,11,71320,68547,139867,104.0454
Portugal,1993,12,74814,71740,146554,104.2849
Portugal,1993,13,75955,73296,149251,103.6278
Portugal,1993,14,77577,74673,152250,103.889
Portugal,1993,15,82455,79812,162267,103.3115
Portugal,1993,16,86369,83454,169823,103.4929
Portugal,1993,17,87715,84745,172460,103.5046
Portugal,1993,18,85502,83866,169368,101.9507
Portugal,1993,19,83320,81333,164653,102.443
Portugal,1993,20,83341,82053,165394,101.5697
Portugal,1993,21,81581,79968,161549,102.0171
Portugal,1993,22,80053,77558,157611,103.2169
Portugal,1993,23,76894,75214,152108,102.2336
Portugal,1993,24,75716,74582,150298,101.5205
Portugal,1993,25,74300,74224,148524,100.1024
Portugal,1993,26,73893,74094,147987,99.7287
Portugal,1993,27,73213,74273,147486,98.5728
Portugal,1993,28,73083,75273,148356,97.0906
Portugal,1993,29,71693,73537,145230,97.4924
Portugal,1993,30,70779,73522,144301,96.2691
Portugal,1993,31,70449,73261,143710,96.1617
Portugal,1993,32,71601,73202,144803,97.8129
Portugal,1993,33,68699,71632,140331,95.9055
Portugal,1993,34,67983,71002,138985,95.748
Portugal,1993,35,68623,71869,140492,95.4834
Portugal,1993,36,65072,68503,133575,94.9915
Portugal,1993,37,66358,70094,136452,94.67
Portugal,1993,38,65465,68405,133870,95.7021
Portugal,1993,39,63061,67041,130102,94.0633
Portugal,1993,40,64261,68851,133112,93.3334
Portugal,1993,41,64181,67576,131757,94.976
Portugal,1993,42,64721,67364,132085,96.0765
Portugal,1993,43,63470,66251,129721,95.8023
Portugal,1993,44,64070,68454,132524,93.5957
Portugal,1993,45,59064,64235,123299,91.9499
Portugal,1993,46,56622,61894,118516,91.4822
Portugal,1993,47,59535,65680,125215,90.644
Portugal,1993,48,55745,62169,117914,89.6669
Portugal,1993,49,54275,59662,113937,90.9708
Portugal,1993,50,52261,57349,109610,91.128
Portugal,1993,51,49239,54036,103275,91.1226
Portugal,1993,52,51575,56677,108252,90.9981
Portugal,1993,53,53117,59045,112162,89.9602
Portugal,1993,54,53812,59576,113388,90.325
Portugal,1993,55,52600,59073,111673,89.0424
Portugal,1993,56,53706,60610,114316,88.6091
Portugal,1993,57,54587,61678,116265,88.5032
Portugal,1993,58,51532,58659,110191,87.8501
Portugal,1993,59,51537,59300,110837,86.9089
Portugal,1993,60,52420,60686,113106,86.3791
Portugal,1993,61,51840,59397,111237,87.2771
Portugal,1993,62,51321,59820,111141,85.7924
Portugal,1993,63,48096,56711,104807,84.8089
Portugal,1993,64,48156,57532,105688,83.703
Portugal,1993,65,44991,54600,99591,82.4011
Portugal,1993,66,46329,56556,102885,81.917
Portugal,1993,67,44510,55035,99545,80.8758
Portugal,1993,68,43025,52989,96014,81.1961
Portugal,1993,69,40405,50575,90980,79.8913
Portugal,1993,70,37830,47626,85456,79.4314
Portugal,1993,71,36210,45839,82049,78.9939
Portugal,1993,72,35123,46507,81630,75.522
Portugal,1993,73,28857,38448,67305,75.0546
Portugal,1993,74,24830,33405,58235,74.3302
Portugal,1993,75,24667,34317,58984,71.8798
Portugal,1993,76,23399,33744,57143,69.3427
Portugal,1993,77,22306,32718,55024,68.1765
Portugal,1993,78,21233,32346,53579,65.6434
Portugal,1993,79,19099,30124,49223,63.4013
Portugal,1993,80,18522,30492,49014,60.7438
Portugal,1993,81,16229,27431,43660,59.163
Portugal,1993,82,14233,25224,39457,56.4264
Portugal,1993,83,11702,21576,33278,54.2362
Portugal,1993,84,9831,19090,28921,51.4982
Portugal,1993,85,7958,16275,24233,48.8971
Portugal,1993,86,6238,13937,20175,44.7586
Portugal,1993,87,4904,11326,16230,43.2986
Portugal,1993,88,3801,9111,12912,41.7188
Portugal,1993,89,3091,7877,10968,39.2408
Portugal,1993,90,2195,6226,8421,35.2554
Portugal,1993,91,1615,4510,6125,35.8093
Portugal,1993,92,1096,3385,4481,32.3781
Portugal,1993,93,715,2243,2958,31.877
Portugal,1993,94,492,1646,2138,29.8906
Portugal,1993,95,342,1194,1536,28.6432
Portugal,1993,96,258,794,1052,32.4937
Portugal,1993,97,119,526,645,22.6236
Portugal,1993,98,92,323,415,28.483
Portugal,1993,99,44,214,258,20.5607
Portugal,1993,100,62,294,356,21.0884
Portugal,1994,0,57622,54886,112508,104.9849
Portugal,1994,1,57634,55000,112634,104.7891
Portugal,1994,2,58249,54901,113150,106.0982
Portugal,1994,3,55526,53058,108584,104.6515
Portugal,1994,4,56291,53691,109982,104.8425
Portugal,1994,5,55055,52581,107636,104.7051
Portugal,1994,6,56307,53396,109703,105.4517
Portugal,1994,7,57934,55226,113160,104.9035
Portugal,1994,8,61124,57953,119077,105.4717
Portugal,1994,9,64875,61420,126295,105.6252
Portugal,1994,10,67102,63261,130363,106.0717
Portugal,1994,11,69900,67141,137041,104.1093
Portugal,1994,12,71415,68706,140121,103.9429
Portugal,1994,13,74761,71833,146594,104.0761
Portugal,1994,14,75648,73105,148753,103.4786
Portugal,1994,15,77301,74536,151837,103.7096
Portugal,1994,16,82188,79620,161808,103.2253
Portugal,1994,17,85873,83177,169050,103.2413
Portugal,1994,18,87035,84203,171238,103.3633
Portugal,1994,19,84821,83278,168099,101.8528
Portugal,1994,20,82452,80692,163144,102.1811
Portugal,1994,21,82488,81317,163805,101.44
Portugal,1994,22,80877,79499,160376,101.7334
Portugal,1994,23,79306,77042,156348,102.9387
Portugal,1994,24,76294,74803,151097,101.9932
Portugal,1994,25,75204,74273,149477,101.2535
Portugal,1994,26,73878,74088,147966,99.7166
Portugal,1994,27,73651,74197,147848,99.2641
Portugal,1994,28,73130,74430,147560,98.2534
Portugal,1994,29,73129,75504,148633,96.8545
Portugal,1994,30,71732,73807,145539,97.1886
Portugal,1994,31,70981,73840,144821,96.1281
Portugal,1994,32,70676,73617,144293,96.005
Portugal,1994,33,71704,73426,145130,97.6548
Portugal,1994,34,68754,71726,140480,95.8565
Portugal,1994,35,68154,71218,139372,95.6977
Portugal,1994,36,68615,71879,140494,95.459
Portugal,1994,37,65278,68684,133962,95.0411
Portugal,1994,38,66475,70232,136707,94.6506
Portugal,1994,39,65450,68432,133882,95.6424
Portugal,1994,40,63107,67103,130210,94.045
Portugal,1994,41,64318,68944,133262,93.2902
Portugal,1994,42,64298,67677,131975,95.0072
Portugal,1994,43,64614,67372,131986,95.9063
Portugal,1994,44,63425,66199,129624,95.8096
Portugal,1994,45,63977,68480,132457,93.4244
Portugal,1994,46,58745,63908,122653,91.9212
Portugal,1994,47,56590,61945,118535,91.3552
Portugal,1994,48,59299,65576,124875,90.4279
Portugal,1994,49,55550,62034,117584,89.5477
Portugal,1994,50,54052,59530,113582,90.7979
Portugal,1994,51,51867,57072,108939,90.8799
Portugal,1994,52,49108,54108,103216,90.7592
Portugal,1994,53,51284,56618,107902,90.579
Portugal,1994,54,52808,58942,111750,89.5932
Portugal,1994,55,53498,59406,112904,90.0549
Portugal,1994,56,52221,58963,111184,88.5657
Portugal,1994,57,53561,60649,114210,88.3131
Portugal,1994,58,54182,61585,115767,87.9792
Portugal,1994,59,51232,58593,109825,87.4371
Portugal,1994,60,51213,59242,110455,86.4471
Portugal,1994,61,51974,60466,112440,85.9557
Portugal,1994,62,51337,59119,110456,86.8367
Portugal,1994,63,50515,59408,109923,85.0306
Portugal,1994,64,47239,56159,103398,84.1165
Portugal,1994,65,47145,56891,104036,82.869
Portugal,1994,66,44064,53932,97996,81.7029
Portugal,1994,67,45162,55829,100991,80.8934
Portugal,1994,68,43306,54192,97498,79.9122
Portugal,1994,69,41692,51984,93676,80.2016
Portugal,1994,70,39003,49566,88569,78.689
Portugal,1994,71,36441,46544,82985,78.2937
Portugal,1994,72,34813,44775,79588,77.751
Portugal,1994,73,33606,45346,78952,74.1102
Portugal,1994,74,27318,37053,64371,73.7268
Portugal,1994,75,23512,32268,55780,72.8648
Portugal,1994,76,23202,33004,56206,70.3006
Portugal,1994,77,21845,32426,54271,67.3688
Portugal,1994,78,20776,31496,52272,65.9639
Portugal,1994,79,19651,30812,50463,63.7771
Portugal,1994,80,18337,30522,48859,60.078
Portugal,1994,81,16654,28445,45099,58.5481
Portugal,1994,82,14422,25310,39732,56.9814
Portugal,1994,83,12485,23005,35490,54.2708
Portugal,1994,84,10108,19440,29548,51.9959
Portugal,1994,85,8369,16999,25368,49.2323
Portugal,1994,86,6689,14252,20941,46.9338
Portugal,1994,87,5120,12071,17191,42.4157
Portugal,1994,88,3962,9619,13581,41.1893
Portugal,1994,89,2999,7593,10592,39.4969
Portugal,1994,90,2384,6451,8835,36.9555
Portugal,1994,91,1667,5032,6699,33.128
Portugal,1994,92,1202,3559,4761,33.7735
Portugal,1994,93,779,2582,3361,30.1704
Portugal,1994,94,509,1676,2185,30.3699
Portugal,1994,95,332,1201,1533,27.6436
Portugal,1994,96,239,823,1062,29.0401
Portugal,1994,97,169,559,728,30.2326
Portugal,1994,98,85,363,448,23.416
Portugal,1994,99,58,210,268,27.619
Portugal,1994,100,59,312,371,18.9103
Portugal,1995,0,55802,52157,107959,106.9885
Portugal,1995,1,57354,54589,111943,105.0651
Portugal,1995,2,57471,54847,112318,104.7842
Portugal,1995,3,58209,54843,113052,106.1375
Portugal,1995,4,55709,53226,108935,104.665
Portugal,1995,5,56289,53742,110031,104.7393
Portugal,1995,6,55500,52961,108461,104.7941
Portugal,1995,7,56578,53689,110267,105.381
Portugal,1995,8,58250,55562,113812,104.8378
Portugal,1995,9,61308,58157,119465,105.4181
Portugal,1995,10,65221,61805,127026,105.5271
Portugal,1995,11,67368,63602,130970,105.9212
Portugal,1995,12,70093,67438,137531,103.9369
Portugal,1995,13,71615,68987,140602,103.8094
Portugal,1995,14,74823,72069,146892,103.8213
Portugal,1995,15,75468,73026,148494,103.344
Portugal,1995,16,77144,74539,151683,103.4948
Portugal,1995,17,82050,79595,161645,103.0844
Portugal,1995,18,85553,83071,168624,102.9878
Portugal,1995,19,86486,83781,170267,103.2287
Portugal,1995,20,84269,82845,167114,101.7189
Portugal,1995,21,81748,80180,161928,101.9556
Portugal,1995,22,81773,80734,162507,101.2869
Portugal,1995,23,80388,79196,159584,101.5051
Portugal,1995,24,78780,76688,155468,102.7279
Portugal,1995,25,75851,74570,150421,101.7178
Portugal,1995,26,74882,74116,148998,101.0335
Portugal,1995,27,73643,74135,147778,99.3363
Portugal,1995,28,73562,74441,148003,98.8192
Portugal,1995,29,73225,74739,147964,97.9743
Portugal,1995,30,73395,75888,149283,96.7149
Portugal,1995,31,71944,74228,146172,96.923
Portugal,1995,32,71331,74305,145636,95.9976
Portugal,1995,33,71034,74047,145081,95.931
Portugal,1995,34,71957,73781,145738,97.5278
Portugal,1995,35,68980,71911,140891,95.9241
Portugal,1995,36,68424,71535,139959,95.6511
Portugal,1995,37,68742,71968,140710,95.5175
Portugal,1995,38,65609,68915,134524,95.2028
Portugal,1995,39,66668,70417,137085,94.676
Portugal,1995,40,65533,68542,134075,95.61
Portugal,1995,41,63267,67233,130500,94.1011
Portugal,1995,42,64422,69090,133512,93.2436
Portugal,1995,43,64482,67869,132351,95.0095
Portugal,1995,44,64610,67434,132044,95.8122
Portugal,1995,45,63413,66225,129638,95.7539
Portugal,1995,46,63970,68546,132516,93.3242
Portugal,1995,47,58487,63671,122158,91.8581
Portugal,1995,48,56581,62037,118618,91.2052
Portugal,1995,49,59127,65548,124675,90.2041
Portugal,1995,50,55420,61961,117381,89.4434
Portugal,1995,51,53902,59471,113373,90.6358
Portugal,1995,52,51492,56878,108370,90.5306
Portugal,1995,53,48993,54229,103222,90.3446
Portugal,1995,54,51054,56613,107667,90.1807
Portugal,1995,55,52620,58919,111539,89.3091
Portugal,1995,56,53276,59348,112624,89.7688
Portugal,1995,57,51968,58915,110883,88.2084
Portugal,1995,58,53513,60780,114293,88.0438
Portugal,1995,59,53862,61544,115406,87.5179
Portugal,1995,60,50970,58577,109547,87.0137
Portugal,1995,61,50909,59240,110149,85.9369
Portugal,1995,62,51613,60278,111891,85.6249
Portugal,1995,63,50883,58888,109771,86.4064
Portugal,1995,64,49721,59009,108730,84.26
Portugal,1995,65,46438,55566,102004,83.5727
Portugal,1995,66,46182,56302,102484,82.0255
Portugal,1995,67,43164,53247,96411,81.0637
Portugal,1995,68,44064,55080,99144,80
Portugal,1995,69,42134,53331,95465,79.0047
Portugal,1995,70,40438,51047,91485,79.2172
Portugal,1995,71,37635,48599,86234,77.4399
Portugal,1995,72,35046,45483,80529,77.053
Portugal,1995,73,33418,43802,77220,76.2933
Portugal,1995,74,32154,44125,76279,72.8703
Portugal,1995,75,25771,35656,61427,72.2768
Portugal,1995,76,22216,31120,53336,71.3882
Portugal,1995,77,21766,31707,53473,68.6473
Portugal,1995,78,20424,31228,51652,65.4028
Portugal,1995,79,19326,30246,49572,63.8961
Portugal,1995,80,18492,29935,48427,61.7738
Portugal,1995,81,16700,28664,45364,58.2612
Portugal,1995,82,15000,26422,41422,56.7709
Portugal,1995,83,12837,23243,36080,55.2295
Portugal,1995,84,10933,20943,31876,52.2036
Portugal,1995,85,8729,17501,26230,49.8771
Portugal,1995,86,7122,15061,22183,47.2877
Portugal,1995,87,5601,12421,18022,45.093
Portugal,1995,88,4227,10370,14597,40.7618
Portugal,1995,89,3219,8166,11385,39.4195
Portugal,1995,90,2380,6363,8743,37.4037
Portugal,1995,91,1888,5230,7118,36.0994
Portugal,1995,92,1247,4035,5282,30.9046
Portugal,1995,93,878,2850,3728,30.807
Portugal,1995,94,576,1973,2549,29.1941
Portugal,1995,95,374,1279,1653,29.2416
Portugal,1995,96,234,914,1148,25.6018
Portugal,1995,97,163,571,734,28.5464
Portugal,1995,98,112,394,506,28.4264
Portugal,1995,99,54,248,302,21.7742
Portugal,1995,100,67,339,406,19.764
Portugal,1996,0,55144,51031,106175,108.0598
Portugal,1996,1,55554,51887,107441,107.0673
Portugal,1996,2,57217,54421,111638,105.1377
Portugal,1996,3,57386,54781,112167,104.7553
Portugal,1996,4,58227,54845,113072,106.1665
Portugal,1996,5,55944,53460,109404,104.6465
Portugal,1996,6,56342,53850,110192,104.6277
Portugal,1996,7,55981,53381,109362,104.8706
Portugal,1996,8,56899,54037,110936,105.2964
Portugal,1996,9,58620,55983,114603,104.7104
Portugal,1996,10,61570,58420,119990,105.392
Portugal,1996,11,65619,62273,127892,105.3731
Portugal,1996,12,67671,63985,131656,105.7607
Portugal,1996,13,70376,67818,138194,103.7719
Portugal,1996,14,71915,69378,141293,103.6568
Portugal,1996,15,74982,72388,147370,103.5835
Portugal,1996,16,75368,73037,148405,103.1915
Portugal,1996,17,77069,74663,151732,103.2225
Portugal,1996,18,82042,79663,161705,102.9863
Portugal,1996,19,85274,83022,168296,102.7125
Portugal,1996,20,85991,83436,169427,103.0622
Portugal,1996,21,83791,82471,166262,101.6006
Portugal,1996,22,81112,79757,160869,101.6989
Portugal,1996,23,81167,80266,161433,101.1225
Portugal,1996,24,80006,78965,158971,101.3183
Portugal,1996,25,78290,76447,154737,102.4108
Portugal,1996,26,75462,74410,149872,101.4138
Portugal,1996,27,74632,74056,148688,100.7778
Portugal,1996,28,73462,74251,147713,98.9374
Portugal,1996,29,73572,74755,148327,98.4175
Portugal,1996,30,73432,75157,148589,97.7048
Portugal,1996,31,73746,76363,150109,96.5729
Portugal,1996,32,72235,74724,146959,96.6691
Portugal,1996,33,71754,74752,146506,95.9894
Portugal,1996,34,71464,74552,146016,95.8579
Portugal,1996,35,72254,74161,146415,97.4286
Portugal,1996,36,69204,72170,141374,95.8903
Portugal,1996,37,68732,71893,140625,95.6032
Portugal,1996,38,68923,72065,140988,95.64
Portugal,1996,39,65953,69167,135120,95.3533
Portugal,1996,40,66873,70668,137541,94.6298
Portugal,1996,41,65648,68683,134331,95.5811
Portugal,1996,42,63412,67385,130797,94.104
Portugal,1996,43,64540,69269,133809,93.173
Portugal,1996,44,64695,68063,132758,95.0516
Portugal,1996,45,64596,67506,132102,95.6893
Portugal,1996,46,63384,66272,129656,95.6422
Portugal,1996,47,63931,68657,132588,93.1165
Portugal,1996,48,58206,63438,121644,91.7526
Portugal,1996,49,56587,62153,118740,91.0447
Portugal,1996,50,58897,65568,124465,89.8258
Portugal,1996,51,55308,61914,117222,89.3304
Portugal,1996,52,53744,59411,113155,90.4614
Portugal,1996,53,51143,56694,107837,90.2088
Portugal,1996,54,48944,54367,103311,90.0252
Portugal,1996,55,50904,56649,107553,89.8586
Portugal,1996,56,52417,58934,111351,88.9419
Portugal,1996,57,53078,59272,112350,89.5499
Portugal,1996,58,51688,58869,110557,87.8017
Portugal,1996,59,53384,60877,114261,87.6916
Portugal,1996,60,53544,61471,115015,87.1045
Portugal,1996,61,50662,58531,109193,86.5558
Portugal,1996,62,50560,59217,109777,85.3809
Portugal,1996,63,51151,60052,111203,85.1778
Portugal,1996,64,50343,58530,108873,86.0123
Portugal,1996,65,48863,58594,107457,83.3925
Portugal,1996,66,45517,54925,100442,82.8712
Portugal,1996,67,45162,55661,100823,81.1376
Portugal,1996,68,42100,52546,94646,80.1203
Portugal,1996,69,42850,54263,97113,78.9673
Portugal,1996,70,40827,52355,93182,77.9811
Portugal,1996,71,39128,49997,89125,78.2607
Portugal,1996,72,36231,47514,83745,76.2533
Portugal,1996,73,33616,44296,77912,75.8895
Portugal,1996,74,31979,42603,74582,75.0628
Portugal,1996,75,30390,42790,73180,71.0213
Portugal,1996,76,24165,34121,58286,70.8215
Portugal,1996,77,20887,29848,50735,69.9779
Portugal,1996,78,20276,30283,50559,66.9551
Portugal,1996,79,19019,29720,48739,63.9939
Portugal,1996,80,18710,30389,49099,61.5683
Portugal,1996,81,16691,28006,44697,59.5979
Portugal,1996,82,15025,26624,41649,56.434
Portugal,1996,83,13344,24254,37598,55.0177
Portugal,1996,84,11299,21218,32517,53.252
Portugal,1996,85,9490,18717,28207,50.7026
Portugal,1996,86,7499,15475,22974,48.4588
Portugal,1996,87,5985,13157,19142,45.4891
Portugal,1996,88,4605,10643,15248,43.2679
Portugal,1996,89,3444,8746,12190,39.378
Portugal,1996,90,2490,6731,9221,36.993
Portugal,1996,91,1849,5189,7038,35.6331
Portugal,1996,92,1393,4125,5518,33.7697
Portugal,1996,93,896,3164,4060,28.3186
Portugal,1996,94,633,2156,2789,29.3599
Portugal,1996,95,396,1465,1861,27.0307
Portugal,1996,96,258,943,1201,27.3595
Portugal,1996,97,162,660,822,24.5455
Portugal,1996,98,109,417,526,26.1391
Portugal,1996,99,72,275,347,26.1818
Portugal,1996,100,71,360,431,19.7222
Portugal,1997,0,56590,52325,108915,108.151
Portugal,1997,1,55007,50948,105955,107.9669
Portugal,1997,2,55389,51708,107097,107.1188
Portugal,1997,3,57123,54312,111435,105.1757
Portugal,1997,4,57354,54748,112102,104.76
Portugal,1997,5,58289,54887,113176,106.1982
Portugal,1997,6,56206,53732,109938,104.6043
Portugal,1997,7,56410,53960,110370,104.5404
Portugal,1997,8,56510,53826,110336,104.9864
Portugal,1997,9,57251,54445,111696,105.1538
Portugal,1997,10,59048,56433,115481,104.6338
Portugal,1997,11,61867,58758,120625,105.2912
Portugal,1997,12,66054,62763,128817,105.2435
Portugal,1997,13,68057,64448,132505,105.5999
Portugal,1997,14,70741,68304,139045,103.5679
Portugal,1997,15,72310,69837,142147,103.5411
Portugal,1997,16,75210,72762,147972,103.3644
Portugal,1997,17,75326,73151,148477,102.9733
Portugal,1997,18,77122,74873,151995,103.0038
Portugal,1997,19,82068,79774,161842,102.8756
Portugal,1997,20,85042,83018,168060,102.438
Portugal,1997,21,85570,83137,168707,102.9265
Portugal,1997,22,83352,82148,165500,101.4656
Portugal,1997,23,80565,79405,159970,101.4609
Portugal,1997,24,80643,79843,160486,101.002
Portugal,1997,25,79664,78831,158495,101.0567
Portugal,1997,26,77845,76265,154110,102.0717
Portugal,1997,27,75124,74356,149480,101.0329
Portugal,1997,28,74455,74061,148516,100.532
Portugal,1997,29,73346,74443,147789,98.5264
Portugal,1997,30,73686,75140,148826,98.0649
Portugal,1997,31,73747,75634,149381,97.5051
Portugal,1997,32,74183,76902,151085,96.4643
Portugal,1997,33,72585,75180,147765,96.5483
Portugal,1997,34,72241,75280,147521,95.9631
Portugal,1997,35,71965,75096,147061,95.8307
Portugal,1997,36,72599,74583,147182,97.3399
Portugal,1997,37,69482,72448,141930,95.906
Portugal,1997,38,69079,72250,141329,95.6111
Portugal,1997,39,69107,72162,141269,95.7665
Portugal,1997,40,66270,69483,135753,95.3758
Portugal,1997,41,67107,70951,138058,94.5822
Portugal,1997,42,65742,68845,134587,95.4928
Portugal,1997,43,63578,67587,131165,94.0684
Portugal,1997,44,64692,69462,134154,93.1329
Portugal,1997,45,64912,68280,133192,95.0674
Portugal,1997,46,64573,67613,132186,95.5038
Portugal,1997,47,63410,66340,129750,95.5834
Portugal,1997,48,63875,68758,132633,92.8983
Portugal,1997,49,57939,63199,121138,91.6771
Portugal,1997,50,56621,62305,118926,90.8771
Portugal,1997,51,58730,65593,124323,89.537
Portugal,1997,52,55174,61856,117030,89.1975
Portugal,1997,53,53530,59362,112892,90.1755
Portugal,1997,54,50794,56519,107313,89.8707
Portugal,1997,55,48868,54556,103424,89.574
Portugal,1997,56,50750,56748,107498,89.4305
Portugal,1997,57,52249,58944,111193,88.6418
Portugal,1997,58,52819,59232,112051,89.1731
Portugal,1997,59,51385,58856,110241,87.3063
Portugal,1997,60,53213,60988,114201,87.2516
Portugal,1997,61,53129,61413,114542,86.511
Portugal,1997,62,50324,58456,108780,86.0887
Portugal,1997,63,50186,59173,109359,84.8123
Portugal,1997,64,50587,59792,110379,84.605
Portugal,1997,65,49745,58142,107887,85.5578
Portugal,1997,66,47925,58074,105999,82.524
Portugal,1997,67,44591,54247,98838,82.1999
Portugal,1997,68,43935,54904,98839,80.0215
Portugal,1997,69,40997,51778,92775,79.1784
Portugal,1997,70,41551,53338,94889,77.9013
Portugal,1997,71,39407,51286,90693,76.8377
Portugal,1997,72,37695,48822,86517,77.209
Portugal,1997,73,34702,46323,81025,74.9131
Portugal,1997,74,32049,43048,75097,74.4495
Portugal,1997,75,30438,41385,71823,73.5484
Portugal,1997,76,28641,41325,69966,69.3067
Portugal,1997,77,22482,32429,54911,69.3268
Portugal,1997,78,19478,28511,47989,68.3175
Portugal,1997,79,18759,28758,47517,65.2305
Portugal,1997,80,18336,29801,48137,61.5281
Portugal,1997,81,16858,28416,45274,59.3257
Portugal,1997,82,14942,26062,41004,57.3325
Portugal,1997,83,13215,24386,37601,54.1909
Portugal,1997,84,11639,21968,33607,52.9816
Portugal,1997,85,9741,19073,28814,51.0722
Portugal,1997,86,8061,16591,24652,48.5866
Portugal,1997,87,6202,13443,19645,46.1355
Portugal,1997,88,4927,11327,16254,43.4978
Portugal,1997,89,3657,8958,12615,40.8238
Portugal,1997,90,2714,7110,9824,38.1716
Portugal,1997,91,1947,5469,7416,35.6007
Portugal,1997,92,1392,4127,5519,33.7291
Portugal,1997,93,1035,3183,4218,32.5165
Portugal,1997,94,648,2336,2984,27.7397
Portugal,1997,95,427,1571,1998,27.1801
Portugal,1997,96,271,1058,1329,25.6144
Portugal,1997,97,190,662,852,28.7009
Portugal,1997,98,107,447,554,23.9374
Portugal,1997,99,70,282,352,24.8227
Portugal,1997,100,79,368,447,21.4674
Portugal,1998,0,57018,54004,111022,105.5811
Portugal,1998,1,56214,52017,108231,108.0685
Portugal,1998,2,54955,50945,105900,107.8712
Portugal,1998,3,55282,51582,106864,107.173
Portugal,1998,4,57074,54230,111304,105.2443
Portugal,1998,5,57347,54762,112109,104.7204
Portugal,1998,6,58363,54961,113324,106.1898
Portugal,1998,7,56488,54005,110493,104.5977
Portugal,1998,8,56503,54085,110588,104.4707
Portugal,1998,9,57056,54339,111395,105.0001
Portugal,1998,10,57659,54876,112535,105.0714
Portugal,1998,11,59516,56956,116472,104.4947
Portugal,1998,12,62188,59110,121298,105.2072
Portugal,1998,13,66569,63327,129896,105.1195
Portugal,1998,14,68513,65017,133530,105.3771
Portugal,1998,15,71209,68840,140049,103.4413
Portugal,1998,16,72767,70357,143124,103.4254
Portugal,1998,17,75507,73241,148748,103.0939
Portugal,1998,18,75427,73327,148754,102.8639
Portugal,1998,19,77196,75097,152293,102.7951
Portugal,1998,20,82114,79926,162040,102.7375
Portugal,1998,21,84877,83037,167914,102.2159
Portugal,1998,22,85123,82872,167995,102.7162
Portugal,1998,23,83002,81886,164888,101.3629
Portugal,1998,24,80063,79081,159144,101.2418
Portugal,1998,25,80137,79516,159653,100.781
Portugal,1998,26,79356,78729,158085,100.7964
Portugal,1998,27,77414,76166,153580,101.6385
Portugal,1998,28,74832,74318,149150,100.6916
Portugal,1998,29,74316,74116,148432,100.2698
Portugal,1998,30,73352,74716,148068,98.1744
Portugal,1998,31,73897,75601,149498,97.7461
Portugal,1998,32,74111,76197,150308,97.2624
Portugal,1998,33,74634,77432,152066,96.3865
Portugal,1998,34,73005,75737,148742,96.3928
Portugal,1998,35,72796,75833,148629,95.9951
Portugal,1998,36,72493,75665,148158,95.8078
Portugal,1998,37,72974,75028,148002,97.2624
Portugal,1998,38,69799,72702,142501,96.007
Portugal,1998,39,69425,72599,142024,95.628
Portugal,1998,40,69306,72295,141601,95.8656
Portugal,1998,41,66653,69807,136460,95.4818
Portugal,1998,42,67355,71232,138587,94.5572
Portugal,1998,43,65896,69024,134920,95.4682
Portugal,1998,44,63761,67795,131556,94.0497
Portugal,1998,45,64892,69663,134555,93.1513
Portugal,1998,46,65167,68515,133682,95.1135
Portugal,1998,47,64607,67764,132371,95.3412
Portugal,1998,48,63424,66393,129817,95.5281
Portugal,1998,49,63869,68861,132730,92.7506
Portugal,1998,50,57687,63007,120694,91.5565
Portugal,1998,51,56645,62471,119116,90.6741
Portugal,1998,52,58562,65640,124202,89.2169
Portugal,1998,53,55071,61874,116945,89.0051
Portugal,1998,54,53364,59334,112698,89.9383
Portugal,1998,55,50529,56373,106902,89.6333
Portugal,1998,56,48877,54781,103658,89.2225
Portugal,1998,57,50689,56818,107507,89.2129
Portugal,1998,58,52107,59000,111107,88.3169
Portugal,1998,59,52587,59144,111731,88.9135
Portugal,1998,60,51090,58851,109941,86.8125
Portugal,1998,61,53020,61048,114068,86.8497
Portugal,1998,62,52662,61360,114022,85.8246
Portugal,1998,63,49967,58390,108357,85.5746
Portugal,1998,64,49769,59082,108851,84.2372
Portugal,1998,65,50069,59496,109565,84.1552
Portugal,1998,66,49099,57748,106847,85.0229
Portugal,1998,67,46901,57582,104483,81.4508
Portugal,1998,68,43554,53485,97039,81.4322
Portugal,1998,69,42807,54084,96891,79.1491
Portugal,1998,70,39780,50918,90698,78.1256
Portugal,1998,71,40271,52453,92724,76.7754
Portugal,1998,72,37948,50178,88126,75.6268
Portugal,1998,73,36169,47608,83777,75.9725
Portugal,1998,74,33163,45103,78266,73.5273
Portugal,1998,75,30492,41713,72205,73.0995
Portugal,1998,76,28933,40069,69002,72.2079
Portugal,1998,77,26924,39732,66656,67.764
Portugal,1998,78,20839,30704,51543,67.8706
Portugal,1998,79,18074,27125,45199,66.6323
Portugal,1998,80,17967,28566,46533,62.8965
Portugal,1998,81,16709,27966,44675,59.7476
Portugal,1998,82,15172,26501,41673,57.2507
Portugal,1998,83,13260,23965,37225,55.3307
Portugal,1998,84,11548,22236,33784,51.9338
Portugal,1998,85,10090,19713,29803,51.1845
Portugal,1998,86,8315,16963,25278,49.0185
Portugal,1998,87,6774,14612,21386,46.3592
Portugal,1998,88,5085,11580,16665,43.9119
Portugal,1998,89,3991,9588,13579,41.6249
Portugal,1998,90,2917,7389,10306,39.4776
Portugal,1998,91,2098,5769,7867,36.3668
Portugal,1998,92,1484,4367,5851,33.9821
Portugal,1998,93,1034,3255,4289,31.7665
Portugal,1998,94,740,2483,3223,29.8027
Portugal,1998,95,459,1758,2217,26.1092
Portugal,1998,96,300,1138,1438,26.362
Portugal,1998,97,177,748,925,23.6631
Portugal,1998,98,129,459,588,28.1046
Portugal,1998,99,72,297,369,24.2424
Portugal,1998,100,89,413,502,21.5496
Portugal,1999,0,57557,54043,111600,106.5022
Portugal,1999,1,56702,53742,110444,105.5078
Portugal,1999,2,56208,52051,108259,107.9864
Portugal,1999,3,54885,50868,105753,107.8969
Portugal,1999,4,55279,51535,106814,107.265
Portugal,1999,5,57104,54298,111402,105.1678
Portugal,1999,6,57477,54877,112354,104.7379
Portugal,1999,7,58683,55275,113958,106.1655
Portugal,1999,8,56629,54182,110811,104.5163
Portugal,1999,9,57093,54636,111729,104.497
Portugal,1999,10,57497,54809,112306,104.9043
Portugal,1999,11,58148,55433,113581,104.8978
Portugal,1999,12,59875,57349,117224,104.4046
Portugal,1999,13,62740,59712,122452,105.071
Portugal,1999,14,67068,63938,131006,104.8954
Portugal,1999,15,69021,65614,134635,105.1925
Portugal,1999,16,71700,69417,141117,103.2888
Portugal,1999,17,73113,70886,143999,103.1417
Portugal,1999,18,75643,73470,149113,102.9577
Portugal,1999,19,75570,73622,149192,102.6459
Portugal,1999,20,77326,75329,152655,102.651
Portugal,1999,21,82035,80020,162055,102.5181
Portugal,1999,22,84543,82845,167388,102.0496
Portugal,1999,23,84845,82690,167535,102.6061
Portugal,1999,24,82617,81631,164248,101.2079
Portugal,1999,25,79642,78812,158454,101.0531
Portugal,1999,26,79917,79471,159388,100.5612
Portugal,1999,27,79064,78680,157744,100.4881
Portugal,1999,28,77215,76197,153412,101.336
Portugal,1999,29,74783,74418,149201,100.4905
Portugal,1999,30,74374,74410,148784,99.9516
Portugal,1999,31,73615,75205,148820,97.8858
Portugal,1999,32,74321,76193,150514,97.5431
Portugal,1999,33,74634,76750,151384,97.243
Portugal,1999,34,75101,78014,153115,96.2661
Portugal,1999,35,73608,76313,149921,96.4554
Portugal,1999,36,73320,76415,149735,95.9497
Portugal,1999,37,72933,76132,149065,95.7981
Portugal,1999,38,73321,75319,148640,97.3473
Portugal,1999,39,70186,73065,143251,96.0597
Portugal,1999,40,69662,72749,142411,95.7566
Portugal,1999,41,69693,72627,142320,95.9602
Portugal,1999,42,66938,70093,137031,95.4988
Portugal,1999,43,67473,71430,138903,94.4603
Portugal,1999,44,66088,69267,135355,95.4105
Portugal,1999,45,63967,68033,132000,94.0235
Portugal,1999,46,65127,69925,135052,93.1384
Portugal,1999,47,65179,68678,133857,94.9052
Portugal,1999,48,64646,67853,132499,95.2736
Portugal,1999,49,63441,66554,129995,95.3226
Portugal,1999,50,63584,68673,132257,92.5895
Portugal,1999,51,57700,63198,120898,91.3004
Portugal,1999,52,56481,62533,119014,90.3219
Portugal,1999,53,58450,65665,124115,89.0124
Portugal,1999,54,54896,61847,116743,88.761
Portugal,1999,55,53065,59222,112287,89.6035
Portugal,1999,56,50541,56596,107137,89.3014
Portugal,1999,57,48816,54904,103720,88.9116
Portugal,1999,58,50593,56877,107470,88.9516
Portugal,1999,59,51922,58960,110882,88.0631
Portugal,1999,60,52295,59089,111384,88.5021
Portugal,1999,61,50994,58952,109946,86.5009
Portugal,1999,62,52586,60950,113536,86.2773
Portugal,1999,63,52311,61261,113572,85.3904
Portugal,1999,64,49573,58336,107909,84.9784
Portugal,1999,65,49259,58819,108078,83.7467
Portugal,1999,66,49360,59137,108497,83.4672
Portugal,1999,67,48104,57203,105307,84.0935
Portugal,1999,68,45893,56950,102843,80.5847
Portugal,1999,69,42373,52728,95101,80.3615
Portugal,1999,70,41624,53159,94783,78.3009
Portugal,1999,71,38516,50029,88545,76.9873
Portugal,1999,72,38822,51280,90102,75.7059
Portugal,1999,73,36398,48963,85361,74.3378
Portugal,1999,74,34563,46335,80898,74.5937
Portugal,1999,75,31550,43718,75268,72.1671
Portugal,1999,76,28821,40392,69213,71.3532
Portugal,1999,77,27301,38547,65848,70.8252
Portugal,1999,78,24849,37639,62488,66.0193
Portugal,1999,79,19474,29273,48747,66.5255
Portugal,1999,80,17362,27389,44751,63.3904
Portugal,1999,81,16269,26826,43095,60.6464
Portugal,1999,82,15018,26084,41102,57.5755
Portugal,1999,83,13446,24442,37888,55.0119
Portugal,1999,84,11589,21821,33410,53.1094
Portugal,1999,85,10034,20076,30110,49.9801
Portugal,1999,86,8617,17464,26081,49.3415
Portugal,1999,87,6974,14915,21889,46.7583
Portugal,1999,88,5589,12626,18215,44.2658
Portugal,1999,89,4080,9767,13847,41.7733
Portugal,1999,90,3180,7968,11148,39.9096
Portugal,1999,91,2279,6055,8334,37.6383
Portugal,1999,92,1593,4602,6195,34.6154
Portugal,1999,93,1118,3370,4488,33.1751
Portugal,1999,94,742,2472,3214,30.0162
Portugal,1999,95,523,1835,2358,28.5014
Portugal,1999,96,328,1308,1636,25.0765
Portugal,1999,97,192,791,983,24.2731
Portugal,1999,98,111,530,641,20.9434
Portugal,1999,99,81,319,400,25.3918
Portugal,1999,100,93,442,535,21.0407
Portugal,2000,0,58876,55456,114332,106.1671
Portugal,2000,1,57276,53843,111119,106.3759
Portugal,2000,2,56762,53841,110603,105.4252
Portugal,2000,3,56196,52030,108226,108.0069
Portugal,2000,4,54932,50885,105817,107.9532
Portugal,2000,5,55367,51657,107024,107.182
Portugal,2000,6,57286,54470,111756,105.1698
Portugal,2000,7,57844,55249,113093,104.6969
Portugal,2000,8,58870,55500,114370,106.0721
Portugal,2000,9,57261,54787,112048,104.5157
Portugal,2000,10,57591,55153,112744,104.4204
Portugal,2000,11,58055,55429,113484,104.7376
Portugal,2000,12,58560,55867,114427,104.8204
Portugal,2000,13,60493,58020,118513,104.2623
Portugal,2000,14,63320,60401,123721,104.8327
Portugal,2000,15,67654,64611,132265,104.7097
Portugal,2000,16,69607,66277,135884,105.0244
Portugal,2000,17,72147,70038,142185,103.0112
Portugal,2000,18,73374,71208,144582,103.0418
Portugal,2000,19,75885,73858,149743,102.7445
Portugal,2000,20,75811,73937,149748,102.5346
Portugal,2000,21,77344,75525,152869,102.4085
Portugal,2000,22,81789,79906,161695,102.3565
Portugal,2000,23,84391,82754,167145,101.9782
Portugal,2000,24,84547,82542,167089,102.4291
Portugal,2000,25,82289,81454,163743,101.0251
Portugal,2000,26,79513,78872,158385,100.8127
Portugal,2000,27,79690,79525,159215,100.2075
Portugal,2000,28,78939,78801,157740,100.1751
Portugal,2000,29,77245,76389,153634,101.1206
Portugal,2000,30,74926,74817,149743,100.1457
Portugal,2000,31,74724,75014,149738,99.6134
Portugal,2000,32,74141,75897,150038,97.6863
Portugal,2000,33,74939,76815,151754,97.5578
Portugal,2000,34,75219,77410,152629,97.1696
Portugal,2000,35,75767,78682,154449,96.2952
Portugal,2000,36,74221,76986,151207,96.4084
Portugal,2000,37,73849,76938,150787,95.9851
Portugal,2000,38,73347,76489,149836,95.8922
Portugal,2000,39,73781,75759,149540,97.3891
Portugal,2000,40,70464,73268,143732,96.173
Portugal,2000,41,70107,73114,143221,95.8872
Portugal,2000,42,70030,72979,143009,95.9591
Portugal,2000,43,67150,70339,137489,95.4662
Portugal,2000,44,67766,71699,139465,94.5146
Portugal,2000,45,66378,69545,135923,95.4461
Portugal,2000,46,64263,68312,132575,94.0728
Portugal,2000,47,65203,70137,135340,92.9652
Portugal,2000,48,65249,68804,134053,94.8331
Portugal,2000,49,64715,68059,132774,95.0866
Portugal,2000,50,63226,66431,129657,95.1754
Portugal,2000,51,63630,68883,132513,92.374
Portugal,2000,52,57606,63323,120929,90.9717
Portugal,2000,53,56426,62585,119011,90.159
Portugal,2000,54,58305,65672,123977,88.7821
Portugal,2000,55,54661,61766,116427,88.4969
Portugal,2000,56,53085,59457,112542,89.283
Portugal,2000,57,50546,56763,107309,89.0474
Portugal,2000,58,48817,55016,103833,88.7324
Portugal,2000,59,50496,56905,107401,88.7374
Portugal,2000,60,51702,58981,110683,87.6587
Portugal,2000,61,52253,59190,111443,88.2801
Portugal,2000,62,50658,58906,109564,85.998
Portugal,2000,63,52235,60881,113116,85.7985
Portugal,2000,64,51948,61248,113196,84.8158
Portugal,2000,65,49151,58093,107244,84.6074
Portugal,2000,66,48639,58429,107068,83.2446
Portugal,2000,67,48386,58607,106993,82.5601
Portugal,2000,68,47114,56521,103635,83.3566
Portugal,2000,69,44708,56195,100903,79.5587
Portugal,2000,70,41168,51897,93065,79.3264
Portugal,2000,71,40370,52261,92631,77.2469
Portugal,2000,72,37176,49042,86218,75.8044
Portugal,2000,73,37219,50043,87262,74.374
Portugal,2000,74,34827,47729,82556,72.9682
Portugal,2000,75,32951,44928,77879,73.3418
Portugal,2000,76,29917,42293,72210,70.7375
Portugal,2000,77,27063,38865,65928,69.6333
Portugal,2000,78,25206,36510,61716,69.0386
Portugal,2000,79,22962,35898,58860,63.9646
Portugal,2000,80,17430,27887,45317,62.5022
Portugal,2000,81,15831,25637,41468,61.7506
Portugal,2000,82,14673,24947,39620,58.8167
Portugal,2000,83,13363,24049,37412,55.5657
Portugal,2000,84,11714,22319,34033,52.4844
Portugal,2000,85,10032,19567,29599,51.27
Portugal,2000,86,8556,17905,26461,47.7855
Portugal,2000,87,7159,15230,22389,47.0059
Portugal,2000,88,5703,12910,18613,44.1751
Portugal,2000,89,4554,10679,15233,42.6444
Portugal,2000,90,3255,8008,11263,40.6469
Portugal,2000,91,2441,6522,8963,37.4272
Portugal,2000,92,1706,4761,6467,35.8328
Portugal,2000,93,1158,3578,4736,32.3644
Portugal,2000,94,813,2575,3388,31.5728
Portugal,2000,95,517,1799,2316,28.7382
Portugal,2000,96,350,1280,1630,27.3438
Portugal,2000,97,221,908,1129,24.3392
Portugal,2000,98,129,555,684,23.2432
Portugal,2000,99,80,367,447,21.7984
Portugal,2000,100,95,455,550,20.8791
Portugal,2001,0,59360,55092,114452,107.747
Portugal,2001,1,57431,54161,111592,106.0376
Portugal,2001,2,55806,52486,108292,106.3255
Portugal,2001,3,55349,52661,108010,105.1043
Portugal,2001,4,55595,51613,107208,107.7151
Portugal,2001,5,55212,51344,106556,107.5335
Portugal,2001,6,55308,51556,106864,107.2775
Portugal,2001,7,57234,54343,111577,105.3199
Portugal,2001,8,57636,55090,112726,104.6215
Portugal,2001,9,58961,55498,114459,106.2399
Portugal,2001,10,57732,55242,112974,104.5074
Portugal,2001,11,57250,55001,112251,104.089
Portugal,2001,12,59166,56289,115455,105.1111
Portugal,2001,13,59302,56677,115979,104.6315
Portugal,2001,14,61446,59057,120503,104.0452
Portugal,2001,15,63920,60912,124832,104.9383
Portugal,2001,16,68871,65793,134664,104.6783
Portugal,2001,17,70679,67383,138062,104.8914
Portugal,2001,18,73307,71203,144510,102.9549
Portugal,2001,19,74895,72639,147534,103.1058
Portugal,2001,20,77106,75253,152359,102.4624
Portugal,2001,21,76236,74356,150592,102.5284
Portugal,2001,22,77937,76328,154265,102.108
Portugal,2001,23,82956,80958,163914,102.4679
Portugal,2001,24,85041,83749,168790,101.5427
Portugal,2001,25,84678,82801,167479,102.2669
Portugal,2001,26,82652,81771,164423,101.0774
Portugal,2001,27,79180,78905,158085,100.3485
Portugal,2001,28,79343,79135,158478,100.2628
Portugal,2001,29,79150,79134,158284,100.0202
Portugal,2001,30,76988,76391,153379,100.7815
Portugal,2001,31,74819,74837,149656,99.9759
Portugal,2001,32,74791,74873,149664,99.8905
Portugal,2001,33,74072,75940,150012,97.5402
Portugal,2001,34,75136,77350,152486,97.1377
Portugal,2001,35,75817,78038,153855,97.154
Portugal,2001,36,76574,79410,155984,96.4287
Portugal,2001,37,74677,77626,152303,96.201
Portugal,2001,38,74717,77658,152375,96.2129
Portugal,2001,39,74343,77492,151835,95.9364
Portugal,2001,40,74373,76469,150842,97.259
Portugal,2001,41,70942,73674,144616,96.2918
Portugal,2001,42,70716,73880,144596,95.7174
Portugal,2001,43,70146,72921,143067,96.1945
Portugal,2001,44,67911,70928,138839,95.7464
Portugal,2001,45,68319,72270,140589,94.533
Portugal,2001,46,66483,69769,136252,95.2902
Portugal,2001,47,64528,68630,133158,94.023
Portugal,2001,48,65507,70504,136011,92.9125
Portugal,2001,49,66000,69403,135403,95.0968
Portugal,2001,50,64750,68383,133133,94.6873
Portugal,2001,51,63576,66865,130441,95.0811
Portugal,2001,52,63956,69488,133444,92.0389
Portugal,2001,53,57061,62665,119726,91.0572
Portugal,2001,54,56840,63119,119959,90.0521
Portugal,2001,55,58218,65918,124136,88.3188
Portugal,2001,56,55015,62059,117074,88.6495
Portugal,2001,57,53319,59581,112900,89.4899
Portugal,2001,58,49926,56229,106155,88.7905
Portugal,2001,59,49046,55520,104566,88.3393
Portugal,2001,60,50377,57206,107583,88.0624
Portugal,2001,61,51538,59083,110621,87.2298
Portugal,2001,62,51816,58904,110720,87.9669
Portugal,2001,63,50016,58608,108624,85.3399
Portugal,2001,64,52264,61169,113433,85.442
Portugal,2001,65,51096,60929,112025,83.8615
Portugal,2001,66,48543,57980,106523,83.7237
Portugal,2001,67,48132,58597,106729,82.1407
Portugal,2001,68,47959,58378,106337,82.1525
Portugal,2001,69,46785,56259,103044,83.16
Portugal,2001,70,43552,55788,99340,78.067
Portugal,2001,71,40059,51019,91078,78.5178
Portugal,2001,72,38991,51332,90323,75.9585
Portugal,2001,73,35998,48080,84078,74.871
Portugal,2001,74,35853,48968,84821,73.2172
Portugal,2001,75,33328,46259,79587,72.0465
Portugal,2001,76,31325,43483,74808,72.0396
Portugal,2001,77,28130,40749,68879,69.0324
Portugal,2001,78,25422,37033,62455,68.6469
Portugal,2001,79,23915,35433,59348,67.4936
Portugal,2001,80,22258,35895,58153,62.0086
Portugal,2001,81,15917,26237,42154,60.6662
Portugal,2001,82,14259,23955,38214,59.5241
Portugal,2001,83,13105,23055,36160,56.8423
Portugal,2001,84,11735,22120,33855,53.0515
Portugal,2001,85,10215,20174,30389,50.6345
Portugal,2001,86,8591,17515,26106,49.0494
Portugal,2001,87,7222,15760,22982,45.8249
Portugal,2001,88,5923,13200,19123,44.8712
Portugal,2001,89,4639,10991,15630,42.2073
Portugal,2001,90,3660,8858,12518,41.3186
Portugal,2001,91,2527,6612,9139,38.2184
Portugal,2001,92,1872,5194,7066,36.0416
Portugal,2001,93,1270,3783,5053,33.5712
Portugal,2001,94,838,2757,3595,30.3954
Portugal,2001,95,551,1958,2509,28.141
Portugal,2001,96,333,1295,1628,25.7143
Portugal,2001,97,236,907,1143,26.0198
Portugal,2001,98,137,654,791,20.948
Portugal,2001,99,78,387,465,20.155
Portugal,2001,100,99,510,609,19.4118
Portugal,2002,0,58136,54264,112400,107.1355
Portugal,2002,1,59538,55302,114840,107.6598
Portugal,2002,2,57705,54423,112128,106.0305
Portugal,2002,3,56104,52783,108887,106.2918
Portugal,2002,4,55637,52939,108576,105.0964
Portugal,2002,5,55915,51917,107832,107.7008
Portugal,2002,6,55561,51678,107239,107.5138
Portugal,2002,7,55612,51840,107452,107.2762
Portugal,2002,8,57572,54646,112218,105.3545
Portugal,2002,9,57979,55399,113378,104.6571
Portugal,2002,10,59333,55835,115168,106.2649
Portugal,2002,11,58198,55601,113799,104.6708
Portugal,2002,12,57692,55322,113014,104.284
Portugal,2002,13,59513,56545,116058,105.2489
Portugal,2002,14,59638,56867,116505,104.8728
Portugal,2002,15,61654,59115,120769,104.295
Portugal,2002,16,64044,60927,124971,105.116
Portugal,2002,17,68898,65757,134655,104.7767
Portugal,2002,18,70766,67471,138237,104.8836
Portugal,2002,19,73379,71312,144691,102.8985
Portugal,2002,20,74934,72708,147642,103.0616
Portugal,2002,21,77181,75437,152618,102.3119
Portugal,2002,22,76460,74700,151160,102.3561
Portugal,2002,23,78205,76800,155005,101.8294
Portugal,2002,24,83428,81622,165050,102.2126
Portugal,2002,25,85447,84382,169829,101.2621
Portugal,2002,26,85143,83502,168645,101.9652
Portugal,2002,27,83066,82502,165568,100.6836
Portugal,2002,28,79728,79692,159420,100.0452
Portugal,2002,29,79876,79936,159812,99.9249
Portugal,2002,30,79635,79819,159454,99.7695
Portugal,2002,31,77392,77088,154480,100.3944
Portugal,2002,32,75301,75540,150841,99.6836
Portugal,2002,33,75186,75513,150699,99.567
Portugal,2002,34,74564,76636,151200,97.2963
Portugal,2002,35,75644,77905,153549,97.0977
Portugal,2002,36,76298,78553,154851,97.1293
Portugal,2002,37,77030,79892,156922,96.4177
Portugal,2002,38,75101,78063,153164,96.2056
Portugal,2002,39,75091,78075,153166,96.178
Portugal,2002,40,74702,77859,152561,95.9452
Portugal,2002,41,74706,76796,151502,97.2785
Portugal,2002,42,71224,73969,145193,96.289
Portugal,2002,43,70963,74190,145153,95.6504
Portugal,2002,44,70336,73139,143475,96.1676
Portugal,2002,45,68104,71132,139236,95.7431
Portugal,2002,46,68463,72489,140952,94.4461
Portugal,2002,47,66598,69933,136531,95.2311
Portugal,2002,48,64630,68766,133396,93.9854
Portugal,2002,49,65541,70629,136170,92.7962
Portugal,2002,50,66044,69538,135582,94.9754
Portugal,2002,51,64781,68486,133267,94.5901
Portugal,2002,52,63518,66928,130446,94.905
Portugal,2002,53,63857,69535,133392,91.8343
Portugal,2002,54,56965,62734,119699,90.804
Portugal,2002,55,56707,63199,119906,89.7277
Portugal,2002,56,58010,65953,123963,87.9566
Portugal,2002,57,54857,62089,116946,88.3522
Portugal,2002,58,53132,59599,112731,89.1491
Portugal,2002,59,49706,56230,105936,88.3977
Portugal,2002,60,48945,55579,104524,88.0638
Portugal,2002,61,50188,57236,107424,87.6861
Portugal,2002,62,51202,59015,110217,86.761
Portugal,2002,63,51432,58783,110215,87.4947
Portugal,2002,64,49484,58417,107901,84.7082
Portugal,2002,65,51815,60968,112783,84.9872
Portugal,2002,66,50419,60628,111047,83.1612
Portugal,2002,67,47724,57630,105354,82.811
Portugal,2002,68,47228,58136,105364,81.2371
Portugal,2002,69,46912,57828,104740,81.1233
Portugal,2002,70,45677,55551,101228,82.2253
Portugal,2002,71,42295,54971,97266,76.9406
Portugal,2002,72,38698,50088,88786,77.26
Portugal,2002,73,37559,50413,87972,74.5026
Portugal,2002,74,34527,47045,81572,73.3914
Portugal,2002,75,34151,47709,81860,71.5819
Portugal,2002,76,31588,44928,76516,70.308
Portugal,2002,77,29530,41975,71505,70.3514
Portugal,2002,78,26356,39171,65527,67.2845
Portugal,2002,79,23622,35348,58970,66.827
Portugal,2002,80,22367,35126,57493,63.6765
Portugal,2002,81,20339,33864,54203,60.0608
Portugal,2002,82,14425,24584,39009,58.6764
Portugal,2002,83,12831,22197,35028,57.8051
Portugal,2002,84,11623,21129,32752,55.0097
Portugal,2002,85,10234,20058,30292,51.022
Portugal,2002,86,8732,18075,26807,48.3098
Portugal,2002,87,7243,15500,22743,46.729
Portugal,2002,88,6043,13757,19800,43.9267
Portugal,2002,89,4812,11351,16163,42.3927
Portugal,2002,90,3686,9201,12887,40.0609
Portugal,2002,91,2879,7393,10272,38.9422
Portugal,2002,92,1953,5322,7275,36.6967
Portugal,2002,93,1401,4104,5505,34.1374
Portugal,2002,94,918,2895,3813,31.7098
Portugal,2002,95,592,2086,2678,28.3797
Portugal,2002,96,381,1466,1847,25.9891
Portugal,2002,97,221,911,1132,24.2591
Portugal,2002,98,152,628,780,24.2038
Portugal,2002,99,81,440,521,18.4091
Portugal,2002,100,111,564,675,19.6809
Portugal,2003,0,58898,54912,113810,107.2589
Portugal,2003,1,57831,54186,112017,106.7268
Portugal,2003,2,59583,55579,115162,107.2042
Portugal,2003,3,57789,54729,112518,105.5912
Portugal,2003,4,56202,53064,109266,105.9136
Portugal,2003,5,55757,53251,109008,104.706
Portugal,2003,6,56060,52256,108316,107.2795
Portugal,2003,7,55690,51975,107665,107.1477
Portugal,2003,8,55802,52154,107956,106.9947
Portugal,2003,9,57779,54970,112749,105.1101
Portugal,2003,10,58205,55741,113946,104.4204
Portugal,2003,11,59545,56169,115714,106.0104
Portugal,2003,12,58524,55971,114495,104.5613
Portugal,2003,13,57995,55638,113633,104.2363
Portugal,2003,14,59712,56789,116501,105.1471
Portugal,2003,15,59808,57094,116902,104.7536
Portugal,2003,16,61685,59175,120860,104.2417
Portugal,2003,17,64009,60982,124991,104.9638
Portugal,2003,18,68810,65906,134716,104.4063
Portugal,2003,19,70583,67610,138193,104.3973
Portugal,2003,20,73166,71463,144629,102.3831
Portugal,2003,21,74587,72834,147421,102.4068
Portugal,2003,22,76909,75727,152636,101.5609
Portugal,2003,23,76294,75123,151417,101.5588
Portugal,2003,24,78026,77314,155340,100.9209
Portugal,2003,25,83373,82306,165679,101.2964
Portugal,2003,26,85357,85036,170393,100.3775
Portugal,2003,27,85092,84208,169300,101.0498
Portugal,2003,28,82989,83260,166249,99.6745
Portugal,2003,29,79821,80468,160289,99.196
Portugal,2003,30,80042,80753,160795,99.1195
Portugal,2003,31,79697,80492,160189,99.0123
Portugal,2003,32,77430,77771,155201,99.5615
Portugal,2003,33,75436,76229,151665,98.9597
Portugal,2003,34,75216,76168,151384,98.7501
Portugal,2003,35,74785,77230,152015,96.8341
Portugal,2003,36,75866,78452,154318,96.7037
Portugal,2003,37,76498,79068,155566,96.7496
Portugal,2003,38,77217,80360,157577,96.0889
Portugal,2003,39,75235,78497,153732,95.8444
Portugal,2003,40,75219,78460,153679,95.8692
Portugal,2003,41,74815,78208,153023,95.6616
Portugal,2003,42,74769,77119,151888,96.9528
Portugal,2003,43,71319,74292,145611,95.9982
Portugal,2003,44,70996,74463,145459,95.344
Portugal,2003,45,70311,73381,143692,95.8164
Portugal,2003,46,68103,71364,139467,95.4305
Portugal,2003,47,68460,72672,141132,94.2041
Portugal,2003,48,66582,70116,136698,94.9598
Portugal,2003,49,64563,68919,133482,93.6795
Portugal,2003,50,65431,70782,136213,92.4402
Portugal,2003,51,65925,69661,135586,94.6369
Portugal,2003,52,64625,68597,133222,94.2097
Portugal,2003,53,63310,67002,130312,94.4897
Portugal,2003,54,63654,69605,133259,91.4503
Portugal,2003,55,56797,62795,119592,90.4483
Portugal,2003,56,56484,63248,119732,89.3056
Portugal,2003,57,57741,66003,123744,87.4824
Portugal,2003,58,54584,62138,116722,87.8432
Portugal,2003,59,52779,59577,112356,88.5896
Portugal,2003,60,49467,56297,105764,87.8679
Portugal,2003,61,48679,55628,104307,87.5081
Portugal,2003,62,49807,57223,107030,87.0402
Portugal,2003,63,50718,58918,109636,86.0824
Portugal,2003,64,50856,58634,109490,86.7347
Portugal,2003,65,48882,58242,107124,83.9291
Portugal,2003,66,51054,60730,111784,84.0672
Portugal,2003,67,49547,60239,109786,82.2507
Portugal,2003,68,46736,57180,103916,81.7349
Portugal,2003,69,46191,57641,103832,80.1357
Portugal,2003,70,45735,57204,102939,79.9507
Portugal,2003,71,44412,54882,99294,80.9227
Portugal,2003,72,40978,54102,95080,75.7421
Portugal,2003,73,37288,49189,86477,75.8056
Portugal,2003,74,36002,49319,85321,72.9982
Portugal,2003,75,32928,45922,78850,71.7042
Portugal,2003,76,32383,46369,78752,69.8376
Portugal,2003,77,29796,43516,73312,68.4714
Portugal,2003,78,27711,40354,68065,68.6698
Portugal,2003,79,24498,37416,61914,65.4747
Portugal,2003,80,22886,36030,58916,63.5193
Portugal,2003,81,20458,33159,53617,61.6967
Portugal,2003,82,18411,31659,50070,58.1541
Portugal,2003,83,12957,22852,35809,56.6996
Portugal,2003,84,11357,20397,31754,55.6798
Portugal,2003,85,10140,19164,29304,52.9117
Portugal,2003,86,8771,18020,26791,48.6737
Portugal,2003,87,7395,15961,23356,46.3317
Portugal,2003,88,6019,13465,19484,44.7011
Portugal,2003,89,4886,11814,16700,41.3577
Portugal,2003,90,3842,9550,13392,40.2304
Portugal,2003,91,2903,7586,10489,38.2679
Portugal,2003,92,2181,5929,8110,36.7853
Portugal,2003,93,1449,4178,5627,34.6817
Portugal,2003,94,993,3168,4161,31.3447
Portugal,2003,95,626,2213,2839,28.2874
Portugal,2003,96,422,1494,1916,28.2463
Portugal,2003,97,261,1069,1330,24.4153
Portugal,2003,98,147,634,781,23.1861
Portugal,2003,99,98,415,513,23.6145
Portugal,2003,100,111,627,738,17.7033
Portugal,2004,0,57889,54151,112040,106.9029
Portugal,2004,1,58494,54658,113152,107.0182
Portugal,2004,2,57540,54026,111566,106.5043
Portugal,2004,3,59613,55755,115368,106.9196
Portugal,2004,4,57827,54901,112728,105.3296
Portugal,2004,5,56256,53253,109509,105.6391
Portugal,2004,6,55822,53458,109280,104.4222
Portugal,2004,7,56128,52430,108558,107.0532
Portugal,2004,8,55797,52163,107960,106.9666
Portugal,2004,9,55922,52347,108269,106.8294
Portugal,2004,10,57920,55175,113095,104.9751
Portugal,2004,11,58332,55943,114275,104.2704
Portugal,2004,12,59673,56371,116044,105.8576
Portugal,2004,13,58759,56205,114964,104.5441
Portugal,2004,14,58206,55818,114024,104.2782
Portugal,2004,15,59814,56922,116736,105.0806
Portugal,2004,16,59898,57182,117080,104.7497
Portugal,2004,17,61642,59123,120765,104.2606
Portugal,2004,18,63908,60984,124892,104.7947
Portugal,2004,19,68595,65858,134453,104.1559
Portugal,2004,20,70263,67534,137797,104.0409
Portugal,2004,21,72825,71391,144216,102.0087
Portugal,2004,22,74120,72754,146874,101.8776
Portugal,2004,23,76518,75763,152281,100.9965
Portugal,2004,24,76009,75256,151265,101.0006
Portugal,2004,25,77743,77533,155276,100.2709
Portugal,2004,26,83219,82685,165904,100.6458
Portugal,2004,27,85133,85371,170504,99.7212
Portugal,2004,28,84936,84607,169543,100.3889
Portugal,2004,29,82833,83699,166532,98.9653
Portugal,2004,30,79856,80964,160820,98.6315
Portugal,2004,31,80035,81269,161304,98.4816
Portugal,2004,32,79607,80884,160491,98.4212
Portugal,2004,33,77358,78175,155533,98.9549
Portugal,2004,34,75424,76697,152121,98.3402
Portugal,2004,35,75309,76548,151857,98.3814
Portugal,2004,36,74899,77582,152481,96.5417
Portugal,2004,37,75964,78778,154742,96.4279
Portugal,2004,38,76576,79381,155957,96.4664
Portugal,2004,39,77272,80639,157911,95.8246
Portugal,2004,40,75288,78748,154036,95.6062
Portugal,2004,41,75248,78683,153931,95.6344
Portugal,2004,42,74804,78432,153236,95.3743
Portugal,2004,43,74785,77331,152116,96.7077
Portugal,2004,44,71250,74456,145706,95.6941
Portugal,2004,45,70942,74628,145570,95.0608
Portugal,2004,46,70257,73517,143774,95.5657
Portugal,2004,47,68020,71478,139498,95.1621
Portugal,2004,48,68300,72756,141056,93.8754
Portugal,2004,49,66426,70197,136623,94.628
Portugal,2004,50,64406,68983,133389,93.365
Portugal,2004,51,65258,70844,136102,92.1151
Portugal,2004,52,65722,69688,135410,94.3089
Portugal,2004,53,64392,68584,132976,93.8878
Portugal,2004,54,63039,67010,130049,94.074
Portugal,2004,55,63372,69605,132977,91.0452
Portugal,2004,56,56497,62746,119243,90.0408
Portugal,2004,57,56176,63226,119402,88.8495
Portugal,2004,58,57388,65943,123331,87.0267
Portugal,2004,59,54198,62074,116272,87.3119
Portugal,2004,60,52427,59533,111960,88.0638
Portugal,2004,61,49037,56238,105275,87.1955
Portugal,2004,62,48231,55535,103766,86.8479
Portugal,2004,63,49311,57050,106361,86.4347
Portugal,2004,64,50128,58699,108827,85.3984
Portugal,2004,65,50197,58395,108592,85.9611
Portugal,2004,66,48066,57922,105988,82.984
Portugal,2004,67,50156,60338,110494,83.1251
Portugal,2004,68,48569,59784,108353,81.2408
Portugal,2004,69,45682,56610,102292,80.696
Portugal,2004,70,44978,57007,101985,78.8991
Portugal,2004,71,44407,56398,100805,78.7386
Portugal,2004,72,43030,54038,97068,79.6291
Portugal,2004,73,39530,53139,92669,74.3898
Portugal,2004,74,35809,48097,83906,74.4516
Portugal,2004,75,34345,48050,82395,71.4776
Portugal,2004,76,31251,44608,75859,70.0569
Portugal,2004,77,30534,44791,75325,68.1699
Portugal,2004,78,27884,41945,69829,66.4775
Portugal,2004,79,25854,38521,64375,67.1166
Portugal,2004,80,23805,37891,61696,62.8249
Portugal,2004,81,20985,33931,54916,61.8461
Portugal,2004,82,18442,31049,49491,59.3964
Portugal,2004,83,16501,29371,45872,56.1813
Portugal,2004,84,11452,21002,32454,54.5281
Portugal,2004,85,9904,18468,28372,53.6279
Portugal,2004,86,8724,17164,25888,50.8273
Portugal,2004,87,7368,15823,23191,46.5651
Portugal,2004,88,6091,13839,19930,44.0133
Portugal,2004,89,4900,11571,16471,42.3472
Portugal,2004,90,3906,9950,13856,39.2563
Portugal,2004,91,2991,7787,10778,38.4102
Portugal,2004,92,2198,6092,8290,36.0801
Portugal,2004,93,1621,4654,6275,34.8303
Portugal,2004,94,1041,3140,4181,33.1529
Portugal,2004,95,705,2362,3067,29.8476
Portugal,2004,96,437,1619,2056,26.992
Portugal,2004,97,281,1053,1334,26.6857
Portugal,2004,98,162,712,874,22.7528
Portugal,2004,99,88,403,491,21.8362
Portugal,2004,100,126,638,764,19.7492
Portugal,2005,0,55858,52933,108791,105.5259
Portugal,2005,1,57466,53893,111359,106.6298
Portugal,2005,2,58071,54384,112455,106.7796
Portugal,2005,3,57217,53816,111033,106.3197
Portugal,2005,4,59601,55861,115462,106.6952
Portugal,2005,5,57834,55020,112854,105.1145
Portugal,2005,6,56271,53379,109650,105.4179
Portugal,2005,7,55841,53568,109409,104.2432
Portugal,2005,8,56185,52548,108733,106.9213
Portugal,2005,9,55870,52288,108158,106.8505
Portugal,2005,10,56007,52481,108488,106.7186
Portugal,2005,11,58007,55307,113314,104.8818
Portugal,2005,12,58414,56077,114491,104.1675
Portugal,2005,13,59747,56503,116250,105.7413
Portugal,2005,14,58940,56355,115295,104.587
Portugal,2005,15,58350,55934,114284,104.3194
Portugal,2005,16,59863,56968,116831,105.0818
Portugal,2005,17,59932,57201,117133,104.7744
Portugal,2005,18,61544,59045,120589,104.2324
Portugal,2005,19,63707,60893,124600,104.6212
Portugal,2005,20,68256,65681,133937,103.9205
Portugal,2005,21,69830,67324,137154,103.7223
Portugal,2005,22,72380,71207,143587,101.6473
Portugal,2005,23,73558,72535,146093,101.4104
Portugal,2005,24,76025,75635,151660,100.5156
Portugal,2005,25,75613,75228,150841,100.5118
Portugal,2005,26,77337,77573,154910,99.6958
Portugal,2005,27,82920,82882,165802,100.0458
Portugal,2005,28,84791,85544,170335,99.1198
Portugal,2005,29,84708,84833,169541,99.8527
Portugal,2005,30,82608,83983,166591,98.3628
Portugal,2005,31,79783,81281,161064,98.157
Portugal,2005,32,79962,81633,161595,97.953
Portugal,2005,33,79451,81127,160578,97.9341
Portugal,2005,34,77199,78456,155655,98.3978
Portugal,2005,35,75480,76968,152448,98.0667
Portugal,2005,36,75332,76797,152129,98.0924
Portugal,2005,37,74901,77828,152729,96.2391
Portugal,2005,38,75988,78989,154977,96.2007
Portugal,2005,39,76591,79594,156185,96.2271
Portugal,2005,40,77251,80831,158082,95.571
Portugal,2005,41,75278,78920,154198,95.3852
Portugal,2005,42,75198,78840,154038,95.3805
Portugal,2005,43,74747,78573,153320,95.1306
Portugal,2005,44,74718,77469,152187,96.4489
Portugal,2005,45,71148,74538,145686,95.452
Portugal,2005,46,70816,74715,145531,94.7815
Portugal,2005,47,70150,73594,143744,95.3203
Portugal,2005,48,67885,71546,139431,94.883
Portugal,2005,49,68117,72816,140933,93.5467
Portugal,2005,50,66255,70227,136482,94.3441
Portugal,2005,51,64171,69005,133176,92.9947
Portugal,2005,52,65037,70859,135896,91.7837
Portugal,2005,53,65463,69661,135124,93.9737
Portugal,2005,54,64144,68564,132708,93.5535
Portugal,2005,55,62724,66999,129723,93.6193
Portugal,2005,56,63057,69539,132596,90.6786
Portugal,2005,57,56183,62684,118867,89.6289
Portugal,2005,58,55791,63166,118957,88.3244
Portugal,2005,59,57015,65839,122854,86.5976
Portugal,2005,60,53851,61988,115839,86.8733
Portugal,2005,61,51993,59438,111431,87.4743
Portugal,2005,62,48556,56105,104661,86.5449
Portugal,2005,63,47704,55395,103099,86.1161
Portugal,2005,64,48767,56856,105623,85.7728
Portugal,2005,65,49487,58411,107898,84.7221
Portugal,2005,66,49463,58106,107569,85.1255
Portugal,2005,67,47278,57502,104780,82.2197
Portugal,2005,68,49217,59852,109069,82.2312
Portugal,2005,69,47521,59246,106767,80.2096
Portugal,2005,70,44620,55999,100619,79.68
Portugal,2005,71,43752,56310,100062,77.6985
Portugal,2005,72,43077,55578,98655,77.5073
Portugal,2005,73,41659,53150,94809,78.3801
Portugal,2005,74,38067,52147,90214,72.9994
Portugal,2005,75,34299,47005,81304,72.9688
Portugal,2005,76,32714,46810,79524,69.8868
Portugal,2005,77,29667,43329,72996,68.4692
Portugal,2005,78,28727,43321,72048,66.312
Portugal,2005,79,25999,40306,66305,64.504
Portugal,2005,80,24972,39033,64005,63.9766
Portugal,2005,81,21908,35946,57854,60.947
Portugal,2005,82,19125,31892,51017,59.968
Portugal,2005,83,16678,29037,45715,57.4371
Portugal,2005,84,14743,27191,41934,54.2201
Portugal,2005,85,10065,19235,29300,52.3265
Portugal,2005,86,8583,16714,25297,51.3522
Portugal,2005,87,7477,15260,22737,48.9974
Portugal,2005,88,6239,14000,20239,44.5643
Portugal,2005,89,5018,12005,17023,41.7993
Portugal,2005,90,4034,9863,13897,40.9003
Portugal,2005,91,3164,8334,11498,37.965
Portugal,2005,92,2331,6420,8751,36.3084
Portugal,2005,93,1686,4918,6604,34.2822
Portugal,2005,94,1211,3645,4856,33.2236
Portugal,2005,95,753,2411,3164,31.2319
Portugal,2005,96,486,1772,2258,27.4266
Portugal,2005,97,292,1216,1508,24.0132
Portugal,2005,98,173,774,947,22.3514
Portugal,2005,99,100,513,613,19.4932
Portugal,2005,100,131,666,797,19.6697
Portugal,2006,0,56328,52637,108965,107.0122
Portugal,2006,1,55492,52653,108145,105.3919
Portugal,2006,2,57097,53672,110769,106.3814
Portugal,2006,3,57687,54141,111828,106.5496
Portugal,2006,4,56922,53606,110528,106.1859
Portugal,2006,5,59612,55985,115597,106.4785
Portugal,2006,6,57853,55152,113005,104.8974
Portugal,2006,7,56295,53492,109787,105.24
Portugal,2006,8,55904,53696,109600,104.112
Portugal,2006,9,56266,52678,108944,106.8112
Portugal,2006,10,55963,52425,108388,106.7487
Portugal,2006,11,56096,52617,108713,106.6119
Portugal,2006,12,58093,55447,113540,104.7721
Portugal,2006,13,58499,56214,114713,104.0648
Portugal,2006,14,59808,56635,116443,105.6025
Portugal,2006,15,59114,56520,115634,104.5895
Portugal,2006,16,58488,56052,114540,104.346
Portugal,2006,17,59902,57037,116939,105.0231
Portugal,2006,18,59976,57299,117275,104.672
Portugal,2006,19,61423,58993,120416,104.1191
Portugal,2006,20,63464,60805,124269,104.373
Portugal,2006,21,67910,65520,133430,103.6477
Portugal,2006,22,69400,67164,136564,103.3292
Portugal,2006,23,71951,71049,143000,101.2695
Portugal,2006,24,73020,72340,145360,100.94
Portugal,2006,25,75542,75517,151059,100.0331
Portugal,2006,26,75231,75208,150439,100.0306
Portugal,2006,27,76962,77623,154585,99.1484
Portugal,2006,28,82681,83094,165775,99.503
Portugal,2006,29,84509,85722,170231,98.585
Portugal,2006,30,84530,85074,169604,99.3606
Portugal,2006,31,82421,84264,166685,97.8128
Portugal,2006,32,79726,81608,161334,97.6939
Portugal,2006,33,79912,81990,161902,97.4655
Portugal,2006,34,79280,81383,160663,97.4159
Portugal,2006,35,77237,78755,155992,98.0725
Portugal,2006,36,75549,77242,152791,97.8082
Portugal,2006,37,75377,77039,152416,97.8427
Portugal,2006,38,74941,78074,153015,95.9871
Portugal,2006,39,75994,79218,155212,95.9302
Portugal,2006,40,76600,79789,156389,96.0032
Portugal,2006,41,77223,81020,158243,95.3135
Portugal,2006,42,75244,79104,154348,95.1203
Portugal,2006,43,75140,78996,154136,95.1187
Portugal,2006,44,74666,78713,153379,94.8585
Portugal,2006,45,74653,77579,152232,96.2284
Portugal,2006,46,71077,74642,145719,95.2239
Portugal,2006,47,70718,74800,145518,94.5428
Portugal,2006,48,69984,73654,143638,95.0172
Portugal,2006,49,67747,71601,139348,94.6174
Portugal,2006,50,67914,72864,140778,93.2065
Portugal,2006,51,66022,70251,136273,93.9802
Portugal,2006,52,63933,69023,132956,92.6256
Portugal,2006,53,64799,70839,135638,91.4736
Portugal,2006,54,65192,69655,134847,93.5927
Portugal,2006,55,63845,68565,132410,93.116
Portugal,2006,56,62389,66935,129324,93.2083
Portugal,2006,57,62673,69488,132161,90.1926
Portugal,2006,58,55819,62645,118464,89.1037
Portugal,2006,59,55359,63073,118432,87.7697
Portugal,2006,60,56589,65778,122367,86.0303
Portugal,2006,61,53427,61901,115328,86.3104
Portugal,2006,62,51512,59309,110821,86.8536
Portugal,2006,63,48076,55968,104044,85.8991
Portugal,2006,64,47191,55208,102399,85.4786
Portugal,2006,65,48144,56615,104759,85.0375
Portugal,2006,66,48758,58081,106839,83.9483
Portugal,2006,67,48595,57712,106307,84.2026
Portugal,2006,68,46382,57053,103435,81.2963
Portugal,2006,69,48203,59309,107512,81.2743
Portugal,2006,70,46460,58640,105100,79.2292
Portugal,2006,71,43418,55330,98748,78.471
Portugal,2006,72,42441,55565,98006,76.3808
Portugal,2006,73,41627,54659,96286,76.1576
Portugal,2006,74,40128,52140,92268,76.962
Portugal,2006,75,36530,50990,87520,71.6415
Portugal,2006,76,32644,45704,78348,71.4248
Portugal,2006,77,30920,45390,76310,68.1207
Portugal,2006,78,27849,41811,69660,66.6069
Portugal,2006,79,26829,41632,68461,64.4432
Portugal,2006,80,24941,39667,64608,62.8759
Portugal,2006,81,22951,36994,59945,62.0398
Portugal,2006,82,19930,33768,53698,59.0204
Portugal,2006,83,17167,29688,46855,57.8247
Portugal,2006,84,14844,26773,41617,55.4439
Portugal,2006,85,12956,24738,37694,52.3729
Portugal,2006,86,8728,17348,26076,50.3113
Portugal,2006,87,7303,14802,22105,49.3379
Portugal,2006,88,6241,13292,19533,46.9531
Portugal,2006,89,5132,12099,17231,42.4167
Portugal,2006,90,4048,10170,14218,39.8033
Portugal,2006,91,3129,8185,11314,38.2285
Portugal,2006,92,2387,6798,9185,35.1133
Portugal,2006,93,1722,5140,6862,33.5019
Portugal,2006,94,1217,3761,4978,32.3584
Portugal,2006,95,873,2808,3681,31.0897
Portugal,2006,96,495,1791,2286,27.6382
Portugal,2006,97,327,1262,1589,25.9113
Portugal,2006,98,181,828,1009,21.8599
Portugal,2006,99,99,529,628,18.7146
Portugal,2006,100,133,729,862,18.2442
Portugal,2007,0,53775,51291,105066,104.843
Portugal,2007,1,56060,52488,108548,106.8054
Portugal,2007,2,55195,52410,107605,105.3139
Portugal,2007,3,56770,53472,110242,106.1677
Portugal,2007,4,57330,53894,111224,106.3755
Portugal,2007,5,56653,53416,110069,106.06
Portugal,2007,6,59645,56127,115772,106.2679
Portugal,2007,7,57892,55280,113172,104.725
Portugal,2007,8,56369,53621,109990,105.1249
Portugal,2007,9,55992,53831,109823,104.0144
Portugal,2007,10,56365,52822,109187,106.7074
Portugal,2007,11,56059,52567,108626,106.643
Portugal,2007,12,56190,52762,108952,106.4971
Portugal,2007,13,58179,55592,113771,104.6535
Portugal,2007,14,58568,56354,114922,103.9287
Portugal,2007,15,59860,56785,116645,105.4152
Portugal,2007,16,59286,56692,115978,104.5756
Portugal,2007,17,58635,56182,114817,104.3662
Portugal,2007,18,59968,57187,117155,104.863
Portugal,2007,19,60007,57429,117436,104.489
Portugal,2007,20,61296,58971,120267,103.9426
Portugal,2007,21,63250,60743,123993,104.1272
Portugal,2007,22,67593,65415,133008,103.3295
Portugal,2007,23,69014,67046,136060,102.9353
Portugal,2007,24,71563,70931,142494,100.891
Portugal,2007,25,72527,72170,144697,100.4947
Portugal,2007,26,75118,75424,150542,99.5943
Portugal,2007,27,74891,75207,150098,99.5798
Portugal,2007,28,76633,77700,154333,98.6268
Portugal,2007,29,82497,83311,165808,99.0229
Portugal,2007,30,84310,85917,170227,98.1296
Portugal,2007,31,84426,85323,169749,98.9487
Portugal,2007,32,82270,84552,166822,97.3011
Portugal,2007,33,79731,81943,161674,97.3006
Portugal,2007,34,79882,82368,162250,96.9818
Portugal,2007,35,79367,81707,161074,97.1361
Portugal,2007,36,77333,79060,156393,97.8156
Portugal,2007,37,75639,77506,153145,97.5912
Portugal,2007,38,75422,77296,152718,97.5756
Portugal,2007,39,74967,78304,153271,95.7384
Portugal,2007,40,76013,79448,155461,95.6764
Portugal,2007,41,76616,79995,156611,95.776
Portugal,2007,42,77191,81198,158389,95.0651
Portugal,2007,43,75216,79295,154511,94.8559
Portugal,2007,44,75077,79145,154222,94.8601
Portugal,2007,45,74607,78857,153464,94.6105
Portugal,2007,46,74550,77710,152260,95.9336
Portugal,2007,47,70966,74766,145732,94.9175
Portugal,2007,48,70574,74886,145460,94.2419
Portugal,2007,49,69825,73746,143571,94.6831
Portugal,2007,50,67565,71673,139238,94.2684
Portugal,2007,51,67713,72912,140625,92.8695
Portugal,2007,52,65808,70299,136107,93.6116
Portugal,2007,53,63697,69052,132749,92.245
Portugal,2007,54,64504,70858,135362,91.0328
Portugal,2007,55,64917,69693,134610,93.1471
Portugal,2007,56,63525,68531,132056,92.6953
Portugal,2007,57,62034,66904,128938,92.7209
Portugal,2007,58,62254,69450,131704,89.6386
Portugal,2007,59,55436,62596,118032,88.5616
Portugal,2007,60,55011,63021,118032,87.29
Portugal,2007,61,56131,65668,121799,85.4769
Portugal,2007,62,52989,61767,114756,85.7885
Portugal,2007,63,50999,59163,110162,86.2008
Portugal,2007,64,47556,55811,103367,85.209
Portugal,2007,65,46667,55030,101697,84.8028
Portugal,2007,66,47456,56365,103821,84.1941
Portugal,2007,67,47979,57758,105737,83.069
Portugal,2007,68,47742,57337,105079,83.2656
Portugal,2007,69,45425,56607,102032,80.2463
Portugal,2007,70,47147,58811,105958,80.167
Portugal,2007,71,45347,57987,103334,78.202
Portugal,2007,72,42193,54654,96847,77.2002
Portugal,2007,73,41120,54747,95867,75.1091
Portugal,2007,74,40166,53708,93874,74.7859
Portugal,2007,75,38517,51122,89639,75.3433
Portugal,2007,76,34923,49909,84832,69.9734
Portugal,2007,77,31019,44445,75464,69.7919
Portugal,2007,78,29161,44022,73183,66.2419
Portugal,2007,79,26101,40278,66379,64.8021
Portugal,2007,80,26049,40854,66903,63.7612
Portugal,2007,81,22935,37752,60687,60.7517
Portugal,2007,82,21118,34968,56086,60.3924
Portugal,2007,83,18113,31668,49781,57.1965
Portugal,2007,84,15351,27703,43054,55.4128
Portugal,2007,85,13202,24602,37804,53.6623
Portugal,2007,86,11292,22419,33711,50.368
Portugal,2007,87,7511,15596,23107,48.1598
Portugal,2007,88,6188,13102,19290,47.2294
Portugal,2007,89,5222,11592,16814,45.0483
Portugal,2007,90,4170,10367,14537,40.2238
Portugal,2007,91,3219,8592,11811,37.4651
Portugal,2007,92,2451,6787,9238,36.1132
Portugal,2007,93,1800,5552,7352,32.4207
Portugal,2007,94,1302,4104,5406,31.7251
Portugal,2007,95,877,2900,3777,30.2414
Portugal,2007,96,610,2097,2707,29.0892
Portugal,2007,97,330,1310,1640,25.1908
Portugal,2007,98,222,905,1127,24.5304
Portugal,2007,99,131,561,692,23.3512
Portugal,2007,100,138,827,965,16.6868
Portugal,2008,0,52374,49674,102048,105.4354
Portugal,2008,1,53489,51133,104622,104.6076
Portugal,2008,2,55840,52394,108234,106.5771
Portugal,2008,3,54915,52231,107146,105.1387
Portugal,2008,4,56450,53301,109751,105.908
Portugal,2008,5,56994,53704,110698,106.1262
Portugal,2008,6,56402,53288,109690,105.8437
Portugal,2008,7,59687,56297,115984,106.0216
Portugal,2008,8,57983,55462,113445,104.5455
Portugal,2008,9,56478,53805,110283,104.9679
Portugal,2008,10,56128,54024,110152,103.8946
Portugal,2008,11,56489,53007,109496,106.5689
Portugal,2008,12,56182,52761,108943,106.484
Portugal,2008,13,56311,52952,109263,106.3435
Portugal,2008,14,58288,55766,114054,104.5225
Portugal,2008,15,58655,56540,115195,103.7407
Portugal,2008,16,59929,56967,116896,105.1995
Portugal,2008,17,59474,56922,116396,104.4833
Portugal,2008,18,58818,56467,115285,104.1635
Portugal,2008,19,60016,57430,117446,104.5029
Portugal,2008,20,60015,57634,117649,104.1312
Portugal,2008,21,61151,59021,120172,103.6089
Portugal,2008,22,63015,60806,123821,103.6329
Portugal,2008,23,67240,65422,132662,102.7789
Portugal,2008,24,68612,67031,135643,102.3586
Portugal,2008,25,71157,70901,142058,100.3611
Portugal,2008,26,72002,72102,144104,99.8613
Portugal,2008,27,74647,75410,150057,98.9882
Portugal,2008,28,74541,75297,149838,98.996
Portugal,2008,29,76297,77847,154144,98.0089
Portugal,2008,30,82362,83616,165978,98.5003
Portugal,2008,31,84112,86187,170299,97.5924
Portugal,2008,32,84299,85637,169936,98.4376
Portugal,2008,33,82149,84892,167041,96.7688
Portugal,2008,34,79773,82342,162115,96.8801
Portugal,2008,35,79998,82778,162776,96.6416
Portugal,2008,36,79486,82078,161564,96.842
Portugal,2008,37,77464,79420,156884,97.5371
Portugal,2008,38,75755,77825,153580,97.3402
Portugal,2008,39,75515,77615,153130,97.2943
Portugal,2008,40,75053,78587,153640,95.5031
Portugal,2008,41,76057,79715,155772,95.4112
Portugal,2008,42,76650,80251,156901,95.5128
Portugal,2008,43,77205,81430,158635,94.8115
Portugal,2008,44,75236,79500,154736,94.6365
Portugal,2008,45,75043,79346,154389,94.5769
Portugal,2008,46,74592,79007,153599,94.4119
Portugal,2008,47,74490,77869,152359,95.6607
Portugal,2008,48,70894,74903,145797,94.6477
Portugal,2008,49,70434,75000,145434,93.912
Portugal,2008,50,69664,73849,143513,94.333
Portugal,2008,51,67416,71770,139186,93.9334
Portugal,2008,52,67509,73001,140510,92.4768
Portugal,2008,53,65539,70354,135893,93.156
Portugal,2008,54,63453,69121,132574,91.7999
Portugal,2008,55,64214,70866,135080,90.6133
Portugal,2008,56,64641,69726,134367,92.7072
Portugal,2008,57,63208,68557,131765,92.1977
Portugal,2008,58,61705,66886,128591,92.254
Portugal,2008,59,61874,69431,131305,89.1158
Portugal,2008,60,55099,62630,117729,87.9754
Portugal,2008,61,54607,63016,117623,86.6558
Portugal,2008,62,55682,65641,121323,84.8281
Portugal,2008,63,52458,61688,114146,85.0376
Portugal,2008,64,50532,59025,109557,85.6112
Portugal,2008,65,47032,55638,102670,84.5322
Portugal,2008,66,46083,54803,100886,84.0885
Portugal,2008,67,46781,56098,102879,83.3916
Portugal,2008,68,47191,57400,104591,82.2143
Portugal,2008,69,46845,56929,103774,82.2867
Portugal,2008,70,44481,56120,100601,79.2605
Portugal,2008,71,46073,58205,104278,79.1564
Portugal,2008,72,44089,57341,101430,76.8891
Portugal,2008,73,40944,53873,94817,76.001
Portugal,2008,74,39711,53795,93506,73.8191
Portugal,2008,75,38600,52671,91271,73.2851
Portugal,2008,76,36953,49987,86940,73.9252
Portugal,2008,77,33286,48671,81957,68.3898
Portugal,2008,78,29297,43062,72359,68.0345
Portugal,2008,79,27443,42472,69915,64.6143
Portugal,2008,80,24959,38681,63640,64.5252
Portugal,2008,81,24106,38845,62951,62.0569
Portugal,2008,82,20983,35691,56674,58.7907
Portugal,2008,83,19125,32822,51947,58.2688
Portugal,2008,84,16229,29414,45643,55.1744
Portugal,2008,85,13661,25491,39152,53.5915
Portugal,2008,86,11603,22329,33932,51.9638
Portugal,2008,87,9764,20138,29902,48.4855
Portugal,2008,88,6351,13808,20159,45.9951
Portugal,2008,89,5112,11348,16460,45.0476
Portugal,2008,90,4253,9880,14133,43.0466
Portugal,2008,91,3357,8674,12031,38.7019
Portugal,2008,92,2551,7102,9653,35.9195
Portugal,2008,93,1870,5452,7322,34.2993
Portugal,2008,94,1331,4416,5747,30.1404
Portugal,2008,95,930,3173,4103,29.3098
Portugal,2008,96,632,2175,2807,29.0575
Portugal,2008,97,406,1549,1955,26.2105
Portugal,2008,98,213,929,1142,22.9279
Portugal,2008,99,159,666,825,23.8739
Portugal,2008,100,166,909,1075,18.2618
Portugal,2009,0,53343,50403,103746,105.833
Portugal,2009,1,51883,49454,101337,104.9116
Portugal,2009,2,53025,50956,103981,104.0604
Portugal,2009,3,55439,52279,107718,106.0445
Portugal,2009,4,54471,52004,106475,104.7439
Portugal,2009,5,55989,53116,109105,105.4089
Portugal,2009,6,56516,53499,110015,105.6394
Portugal,2009,7,56034,53112,109146,105.5016
Portugal,2009,8,59710,56467,116177,105.7432
Portugal,2009,9,58058,55640,113698,104.3458
Portugal,2009,10,56590,53991,110581,104.8138
Portugal,2009,11,56237,54215,110452,103.7296
Portugal,2009,12,56597,53194,109791,106.3973
Portugal,2009,13,56283,52944,109227,106.3067
Portugal,2009,14,56393,53115,109508,106.1715
Portugal,2009,15,58318,55940,114258,104.251
Portugal,2009,16,58665,56707,115372,103.4528
Portugal,2009,17,59913,57135,117048,104.8622
Portugal,2009,18,59533,57192,116725,104.0932
Portugal,2009,19,58745,56698,115443,103.6104
Portugal,2009,20,59709,57580,117289,103.6975
Portugal,2009,21,59626,57734,117360,103.2771
Portugal,2009,22,60560,59006,119566,102.6336
Portugal,2009,23,62300,60769,123069,102.5194
Portugal,2009,24,66395,65323,131718,101.6411
Portugal,2009,25,67678,66884,134562,101.1871
Portugal,2009,26,70194,70740,140934,99.2282
Portugal,2009,27,70919,71880,142799,98.663
Portugal,2009,28,73673,75283,148956,97.8614
Portugal,2009,29,73721,75236,148957,97.9863
Portugal,2009,30,75613,77889,153502,97.0779
Portugal,2009,31,81874,83810,165684,97.69
Portugal,2009,32,83642,86344,169986,96.8707
Portugal,2009,33,83960,85853,169813,97.7951
Portugal,2009,34,81780,85188,166968,95.9994
Portugal,2009,35,79753,82729,162482,96.4027
Portugal,2009,36,79986,83137,163123,96.2099
Portugal,2009,37,79511,82426,161937,96.4635
Portugal,2009,38,77453,79738,157191,97.1344
Portugal,2009,39,75745,78120,153865,96.9598
Portugal,2009,40,75497,77875,153372,96.9464
Portugal,2009,41,75020,78838,153858,95.1572
Portugal,2009,42,76037,79943,155980,95.114
Portugal,2009,43,76626,80491,157117,95.1982
Portugal,2009,44,77142,81640,158782,94.4904
Portugal,2009,45,75161,79692,154853,94.3144
Portugal,2009,46,74973,79524,154497,94.2772
Portugal,2009,47,74536,79164,153700,94.1539
Portugal,2009,48,74420,78018,152438,95.3882
Portugal,2009,49,70781,75009,145790,94.3633
Portugal,2009,50,70269,75122,145391,93.5398
Portugal,2009,51,69485,73957,143442,93.9532
Portugal,2009,52,67216,71868,139084,93.527
Portugal,2009,53,67278,73072,140350,92.0708
Portugal,2009,54,65286,70422,135708,92.7068
Portugal,2009,55,63182,69178,132360,91.3325
Portugal,2009,56,63933,70900,134833,90.1735
Portugal,2009,57,64352,69759,134111,92.249
Portugal,2009,58,62870,68558,131428,91.7034
Portugal,2009,59,61349,66834,128183,91.7931
Portugal,2009,60,61501,69447,130948,88.5582
Portugal,2009,61,54738,62647,117385,87.3753
Portugal,2009,62,54192,62984,117176,86.0409
Portugal,2009,63,55232,65575,120807,84.2272
Portugal,2009,64,51926,61561,113487,84.3489
Portugal,2009,65,50046,58888,108934,84.9851
Portugal,2009,66,46455,55437,101892,83.7978
Portugal,2009,67,45429,54614,100043,83.182
Portugal,2009,68,46075,55760,101835,82.6309
Portugal,2009,69,46293,56953,103246,81.2828
Portugal,2009,70,45924,56429,102353,81.3837
Portugal,2009,71,43466,55576,99042,78.21
Portugal,2009,72,44873,57513,102386,78.0224
Portugal,2009,73,42827,56559,99386,75.7209
Portugal,2009,74,39607,53051,92658,74.6583
Portugal,2009,75,38286,52823,91109,72.4798
Portugal,2009,76,36985,51521,88506,71.7863
Portugal,2009,77,35316,48693,84009,72.5279
Portugal,2009,78,31570,47300,78870,66.7442
Portugal,2009,79,27434,41630,69064,65.8996
Portugal,2009,80,26097,40820,66917,63.9319
Portugal,2009,81,23075,36872,59947,62.5814
Portugal,2009,82,22049,36757,58806,59.9859
Portugal,2009,83,19120,33607,52727,56.8929
Portugal,2009,84,17192,30462,47654,56.4375
Portugal,2009,85,14411,27016,41427,53.3425
Portugal,2009,86,12042,23231,35273,51.8359
Portugal,2009,87,10023,20020,30043,50.0649
Portugal,2009,88,8235,17893,26128,46.0236
Portugal,2009,89,5329,12034,17363,44.2829
Portugal,2009,90,4139,9730,13869,42.5385
Portugal,2009,91,3372,8334,11706,40.4608
Portugal,2009,92,2631,7224,9855,36.4203
Portugal,2009,93,1991,5694,7685,34.9666
Portugal,2009,94,1408,4290,5698,32.8205
Portugal,2009,95,970,3396,4366,28.563
Portugal,2009,96,649,2376,3025,27.3148
Portugal,2009,97,441,1582,2023,27.8761
Portugal,2009,98,289,1115,1404,25.9193
Portugal,2009,99,145,662,807,21.9033
Portugal,2009,100,196,996,1192,19.6787
Portugal,2010,0,50321,48438,98759,103.8874
Portugal,2010,1,52839,50172,103011,105.3157
Portugal,2010,2,51523,49294,100817,104.5218
Portugal,2010,3,52669,50823,103492,103.6322
Portugal,2010,4,55135,52188,107323,105.6469
Portugal,2010,5,54120,51828,105948,104.4223
Portugal,2010,6,55600,52978,108578,104.9492
Portugal,2010,7,56116,53301,109417,105.2813
Portugal,2010,8,55798,52978,108776,105.323
Portugal,2010,9,59805,56668,116473,105.5358
Portugal,2010,10,58189,55850,114039,104.188
Portugal,2010,11,56715,54203,110918,104.6344
Portugal,2010,12,56359,54428,110787,103.5478
Portugal,2010,13,56717,53396,110113,106.2196
Portugal,2010,14,56388,53127,109515,106.1381
Portugal,2010,15,56453,53317,109770,105.8818
Portugal,2010,16,58358,56130,114488,103.9694
Portugal,2010,17,58688,56900,115588,103.1424
Portugal,2010,18,59912,57420,117332,104.34
Portugal,2010,19,59563,57522,117085,103.5482
Portugal,2010,20,58639,56964,115603,102.9405
Portugal,2010,21,59448,57789,117237,102.8708
Portugal,2010,22,59300,57943,117243,102.342
Portugal,2010,23,60085,59089,119174,101.6856
Portugal,2010,24,61725,60817,122542,101.493
Portugal,2010,25,65700,65293,130993,100.6233
Portugal,2010,26,66902,66808,133710,100.1407
Portugal,2010,27,69406,70645,140051,98.2462
Portugal,2010,28,70054,71740,141794,97.6498
Portugal,2010,29,72910,75218,148128,96.9316
Portugal,2010,30,73197,75270,148467,97.2459
Portugal,2010,31,75122,77995,153117,96.3164
Portugal,2010,32,81564,84057,165621,97.0342
Portugal,2010,33,83338,86545,169883,96.2944
Portugal,2010,34,83722,86126,169848,97.2087
Portugal,2010,35,81823,85627,167450,95.5575
Portugal,2010,36,79822,83126,162948,96.0253
Portugal,2010,37,80067,83515,163582,95.8714
Portugal,2010,38,79574,82774,162348,96.1341
Portugal,2010,39,77494,80070,157564,96.7828
Portugal,2010,40,75777,78418,154195,96.6322
Portugal,2010,41,75522,78137,153659,96.6533
Portugal,2010,42,75049,79118,154167,94.857
Portugal,2010,43,76028,80215,156243,94.7803
Portugal,2010,44,76650,80738,157388,94.9367
Portugal,2010,45,77115,81847,158962,94.2185
Portugal,2010,46,75133,79907,155040,94.0256
Portugal,2010,47,74902,79710,154612,93.9681
Portugal,2010,48,74476,79305,153781,93.9109
Portugal,2010,49,74335,78161,152496,95.105
Portugal,2010,50,70645,75145,145790,94.0116
Portugal,2010,51,70130,75224,145354,93.2282
Portugal,2010,52,69303,74040,143343,93.6021
Portugal,2010,53,66986,71961,138947,93.0865
Portugal,2010,54,67030,73136,140166,91.6512
Portugal,2010,55,65024,70489,135513,92.247
Portugal,2010,56,62915,69229,132144,90.8795
Portugal,2010,57,63622,70940,134562,89.6842
Portugal,2010,58,64023,69798,133821,91.7261
Portugal,2010,59,62536,68599,131135,91.1617
Portugal,2010,60,61035,66876,127911,91.2659
Portugal,2010,61,61102,69419,130521,88.0191
Portugal,2010,62,54286,62655,116941,86.6427
Portugal,2010,63,53780,62910,116690,85.4872
Portugal,2010,64,54682,65425,120107,83.5797
Portugal,2010,65,51402,61414,112816,83.6975
Portugal,2010,66,49446,58682,108128,84.2609
Portugal,2010,67,45816,55227,101043,82.9594
Portugal,2010,68,44788,54305,99093,82.4749
Portugal,2010,69,45267,55378,100645,81.7418
Portugal,2010,70,45367,56568,101935,80.1991
Portugal,2010,71,44923,55888,100811,80.3804
Portugal,2010,72,42406,55006,97412,77.0934
Portugal,2010,73,43656,56787,100443,76.8767
Portugal,2010,74,41500,55762,97262,74.4234
Portugal,2010,75,38235,52064,90299,73.4385
Portugal,2010,76,36762,51732,88494,71.0624
Portugal,2010,77,35359,50336,85695,70.2459
Portugal,2010,78,33641,47346,80987,71.0535
Portugal,2010,79,29773,45826,75599,64.9697
Portugal,2010,80,26512,40083,66595,66.1428
Portugal,2010,81,24144,38758,62902,62.2942
Portugal,2010,82,21204,34956,56160,60.6591
Portugal,2010,83,20098,34530,54628,58.2045
Portugal,2010,84,17209,31235,48444,55.0952
Portugal,2010,85,15363,28112,43475,54.6493
Portugal,2010,86,12630,24714,37344,51.1046
Portugal,2010,87,10416,20946,31362,49.7279
Portugal,2010,88,8617,17829,26446,48.3314
Portugal,2010,89,6898,15678,22576,43.998
Portugal,2010,90,4356,10359,14715,42.0504
Portugal,2010,91,3365,8252,11617,40.778
Portugal,2010,92,2690,6857,9547,39.23
Portugal,2010,93,2001,5837,7838,34.2813
Portugal,2010,94,1489,4481,5970,33.2292
Portugal,2010,95,1026,3340,4366,30.7186
Portugal,2010,96,704,2622,3326,26.8497
Portugal,2010,97,442,1744,2186,25.344
Portugal,2010,98,282,1127,1409,25.0222
Portugal,2010,99,194,770,964,25.1948
Portugal,2010,100,211,1031,1242,20.4656
Portugal,2011,0,50868,49624,100492,102.5069
Portugal,2011,1,49484,47511,96995,104.1527
Portugal,2011,2,51975,49154,101129,105.7391
Portugal,2011,3,50782,48343,99125,105.0452
Portugal,2011,4,51936,49871,101807,104.1407
Portugal,2011,5,54458,51309,105767,106.1373
Portugal,2011,6,53376,50854,104230,104.9593
Portugal,2011,7,54857,52012,106869,105.4699
Portugal,2011,8,55458,52326,107784,105.9856
Portugal,2011,9,55263,52080,107343,106.1118
Portugal,2011,10,59905,56848,116753,105.3775
Portugal,2011,11,58281,56024,114305,104.0286
Portugal,2011,12,56805,54384,111189,104.4517
Portugal,2011,13,56446,54597,111043,103.3866
Portugal,2011,14,56775,53542,110317,106.0383
Portugal,2011,15,56393,53282,109675,105.8387
Portugal,2011,16,56434,53459,109893,105.565
Portugal,2011,17,58326,56263,114589,103.6667
Portugal,2011,18,58581,57105,115686,102.5847
Portugal,2011,19,59678,57625,117303,103.5627
Portugal,2011,20,59267,57718,116985,102.6837
Portugal,2011,21,58231,57101,115332,101.9789
Portugal,2011,22,58860,57903,116763,101.6528
Portugal,2011,23,58643,58026,116669,101.0633
Portugal,2011,24,59244,59032,118276,100.3591
Portugal,2011,25,60766,60711,121477,100.0906
Portugal,2011,26,64635,65108,129743,99.2735
Portugal,2011,27,65754,66571,132325,98.7727
Portugal,2011,28,68323,70403,138726,97.0456
Portugal,2011,29,68921,71444,140365,96.4686
Portugal,2011,30,72006,75036,147042,95.9619
Portugal,2011,31,72466,75169,147635,96.4041
Portugal,2011,32,74469,77971,152440,95.5086
Portugal,2011,33,81118,84188,165306,96.3534
Portugal,2011,34,82870,86649,169519,95.6387
Portugal,2011,35,83627,86487,170114,96.6931
Portugal,2011,36,81772,85967,167739,95.1202
Portugal,2011,37,79795,83453,163248,95.6167
Portugal,2011,38,80040,83817,163857,95.4938
Portugal,2011,39,79521,83034,162555,95.7692
Portugal,2011,40,77411,80322,157733,96.3758
Portugal,2011,41,75712,78656,154368,96.2571
Portugal,2011,42,75441,78372,153813,96.2601
Portugal,2011,43,75015,79336,154351,94.5535
Portugal,2011,44,75970,80414,156384,94.4736
Portugal,2011,45,76570,80937,157507,94.6044
Portugal,2011,46,77018,82040,159058,93.8786
Portugal,2011,47,75078,80066,155144,93.7701
Portugal,2011,48,74803,79870,154673,93.6559
Portugal,2011,49,74388,79428,153816,93.6546
Portugal,2011,50,74240,78286,152526,94.8318
Portugal,2011,51,70501,75246,145747,93.694
Portugal,2011,52,69961,75320,145281,92.885
Portugal,2011,53,69060,74118,143178,93.1757
Portugal,2011,54,66743,72027,138770,92.6639
Portugal,2011,55,66704,73182,139886,91.1481
Portugal,2011,56,64728,70542,135270,91.7581
Portugal,2011,57,62605,69273,131878,90.3743
Portugal,2011,58,63245,70956,134201,89.1327
Portugal,2011,59,63618,69803,133421,91.1393
Portugal,2011,60,62222,68647,130869,90.6405
Portugal,2011,61,60624,66882,127506,90.6432
Portugal,2011,62,60595,69363,129958,87.3593
Portugal,2011,63,53793,62619,116412,85.9052
Portugal,2011,64,53267,62804,116071,84.8147
Portugal,2011,65,54175,65286,119461,82.981
Portugal,2011,66,50806,61228,112034,82.9784
Portugal,2011,67,48720,58436,107156,83.3733
Portugal,2011,68,45087,54920,100007,82.0958
Portugal,2011,69,44025,53987,98012,81.5474
Portugal,2011,70,44374,54986,99360,80.7005
Portugal,2011,71,44325,56021,100346,79.1221
Portugal,2011,72,43785,55291,99076,79.1901
Portugal,2011,73,41284,54303,95587,76.0253
Portugal,2011,74,42299,55972,98271,75.5717
Portugal,2011,75,40103,54918,95021,73.0234
Portugal,2011,76,36755,50967,87722,72.1153
Portugal,2011,77,35189,50603,85792,69.5394
Portugal,2011,78,33570,48976,82546,68.5438
Portugal,2011,79,31830,45947,77777,69.2755
Portugal,2011,80,26158,39924,66082,65.5195
Portugal,2011,81,24605,38117,62722,64.5513
Portugal,2011,82,22215,36653,58868,60.609
Portugal,2011,83,19369,32734,52103,59.1709
Portugal,2011,84,18115,32198,50313,56.2613
Portugal,2011,85,15285,28838,44123,53.003
Portugal,2011,86,13437,25608,39045,52.4719
Portugal,2011,87,10913,22318,33231,48.8978
Portugal,2011,88,8911,18710,27621,47.6269
Portugal,2011,89,7229,15617,22846,46.2893
Portugal,2011,90,5637,13485,19122,41.802
Portugal,2011,91,3504,8783,12287,39.8953
Portugal,2011,92,2634,6794,9428,38.7695
Portugal,2011,93,2052,5586,7638,36.7347
Portugal,2011,94,1486,4605,6091,32.2693
Portugal,2011,95,1083,3443,4526,31.4551
Portugal,2011,96,725,2517,3242,28.8041
Portugal,2011,97,488,1942,2430,25.1287
Portugal,2011,98,289,1241,1530,23.2877
Portugal,2011,99,183,787,970,23.2529
Portugal,2011,100,241,1150,1391,20.9565
Portugal,2012,0,49053,46649,95702,105.1534
Portugal,2012,1,50332,49187,99519,102.3279
Portugal,2012,2,48984,47101,96085,103.9978
Portugal,2012,3,51502,48778,100280,105.5845
Portugal,2012,4,50351,48007,98358,104.8826
Portugal,2012,5,51526,49547,101073,103.9942
Portugal,2012,6,54080,51000,105080,106.0392
Portugal,2012,7,53049,50602,103651,104.8358
Portugal,2012,8,54568,51802,106370,105.3396
Portugal,2012,9,55202,52138,107340,105.8767
Portugal,2012,10,55052,51920,106972,106.0324
Portugal,2012,11,59751,56722,116473,105.3401
Portugal,2012,12,58179,55932,114111,104.0174
Portugal,2012,13,56700,54296,110996,104.4276
Portugal,2012,14,56321,54545,110866,103.256
Portugal,2012,15,56667,53494,110161,105.9315
Portugal,2012,16,56263,53246,109509,105.6662
Portugal,2012,17,56206,53411,109617,105.233
Portugal,2012,18,58037,56257,114294,103.1641
Portugal,2012,19,58267,57043,115310,102.1457
Portugal,2012,20,59244,57527,116771,102.9847
Portugal,2012,21,58748,57684,116432,101.8445
Portugal,2012,22,57823,57021,114844,101.4065
Portugal,2012,23,58465,57849,116314,101.0648
Portugal,2012,24,58169,57991,116160,100.3069
Portugal,2012,25,58768,59034,117802,99.5494
Portugal,2012,26,60272,60623,120895,99.421
Portugal,2012,27,64092,65040,129132,98.5424
Portugal,2012,28,65205,66427,131632,98.1604
Portugal,2012,29,67782,70268,138050,96.4621
Portugal,2012,30,68386,71352,139738,95.8431
Portugal,2012,31,71420,74926,146346,95.3207
Portugal,2012,32,71764,75058,146822,95.6114
Portugal,2012,33,73744,77879,151623,94.6905
Portugal,2012,34,80406,84176,164582,95.5213
Portugal,2012,35,82126,86634,168760,94.7965
Portugal,2012,36,82918,86524,169442,95.8324
Portugal,2012,37,81104,86024,167128,94.2807
Portugal,2012,38,79205,83522,162727,94.8313
Portugal,2012,39,79447,83816,163263,94.7874
Portugal,2012,40,78995,83012,162007,95.1609
Portugal,2012,41,76854,80263,157117,95.7527
Portugal,2012,42,75189,78564,153753,95.7041
Portugal,2012,43,74952,78259,153211,95.7743
Portugal,2012,44,74472,79168,153640,94.0683
Portugal,2012,45,75348,80227,155575,93.9185
Portugal,2012,46,75955,80734,156689,94.0806
Portugal,2012,47,76318,81841,158159,93.2515
Portugal,2012,48,74332,79876,154208,93.0592
Portugal,2012,49,74058,79677,153735,92.9478
Portugal,2012,50,73687,79251,152938,92.9793
Portugal,2012,51,73611,78096,151707,94.2571
Portugal,2012,52,69858,75067,144925,93.0609
Portugal,2012,53,69311,75129,144440,92.256
Portugal,2012,54,68446,73953,142399,92.5534
Portugal,2012,55,66173,71833,138006,92.1206
Portugal,2012,56,66126,72988,139114,90.5985
Portugal,2012,57,64161,70334,134495,91.2233
Portugal,2012,58,62013,69043,131056,89.8179
Portugal,2012,59,62614,70746,133360,88.5054
Portugal,2012,60,63113,69556,132669,90.737
Portugal,2012,61,61659,68377,130036,90.1751
Portugal,2012,62,60047,66630,126677,90.1201
Portugal,2012,63,59956,69070,129026,86.8047
Portugal,2012,64,53201,62322,115523,85.3647
Portugal,2012,65,52593,62435,115028,84.2364
Portugal,2012,66,53446,64905,118351,82.345
Portugal,2012,67,50006,60833,110839,82.2021
Portugal,2012,68,47853,58013,105866,82.4867
Portugal,2012,69,44187,54476,98663,81.1128
Portugal,2012,70,43110,53478,96588,80.6126
Portugal,2012,71,43335,54399,97734,79.6614
Portugal,2012,72,43152,55311,98463,78.017
Portugal,2012,73,42541,54512,97053,78.0397
Portugal,2012,74,39988,53423,93411,74.8517
Portugal,2012,75,40852,54987,95839,74.2939
Portugal,2012,76,38577,53798,92375,71.7071
Portugal,2012,77,35238,49691,84929,70.9143
Portugal,2012,78,33509,49223,82732,68.0759
Portugal,2012,79,31774,47370,79144,67.0762
Portugal,2012,80,29979,44312,74291,67.6544
Portugal,2012,81,24370,38170,62540,63.846
Portugal,2012,82,22720,36244,58964,62.6862
Portugal,2012,83,20297,34490,54787,58.8489
Portugal,2012,84,17606,30606,48212,57.5247
Portugal,2012,85,16242,29847,46089,54.4175
Portugal,2012,86,13506,26508,40014,50.9507
Portugal,2012,87,11725,23253,34978,50.4236
Portugal,2012,88,9457,19943,29400,47.4201
Portugal,2012,89,7563,16571,24134,45.64
Portugal,2012,90,6021,13644,19665,44.1293
Portugal,2012,91,4586,11475,16061,39.9651
Portugal,2012,92,2803,7352,10155,38.1257
Portugal,2012,93,2035,5559,7594,36.6073
Portugal,2012,94,1574,4449,6023,35.3787
Portugal,2012,95,1128,3675,4803,30.6939
Portugal,2012,96,762,2649,3411,28.7656
Portugal,2012,97,509,1933,2442,26.3321
Portugal,2012,98,337,1432,1769,23.5335
Portugal,2012,99,178,878,1056,20.2733
Portugal,2012,100,262,1284,1546,20.405
Portugal,2013,0,46052,43548,89600,105.75
Portugal,2013,1,49029,46634,95663,105.1357
Portugal,2013,2,50331,49177,99508,102.3466
Portugal,2013,3,48949,47086,96035,103.9566
Portugal,2013,4,51414,48745,100159,105.4754
Portugal,2013,5,50256,47973,98229,104.7589
Portugal,2013,6,51430,49494,100924,103.9116
Portugal,2013,7,53993,50930,104923,106.0141
Portugal,2013,8,52954,50530,103484,104.7972
Portugal,2013,9,54524,51775,106299,105.3095
Portugal,2013,10,55170,52109,107279,105.8742
Portugal,2013,11,55004,51881,106885,106.0195
Portugal,2013,12,59688,56665,116353,105.3349
Portugal,2013,13,58131,55853,113984,104.0786
Portugal,2013,14,56637,54220,110857,104.4578
Portugal,2013,15,56139,54414,110553,103.1701
Portugal,2013,16,56413,53312,109725,105.8167
Portugal,2013,17,55911,53041,108952,105.4109
Portugal,2013,18,55545,53219,108764,104.3706
Portugal,2013,19,57323,55887,113210,102.5695
Portugal,2013,20,57483,56562,114045,101.6283
Portugal,2013,21,58322,57035,115357,102.2565
Portugal,2013,22,57769,56989,114758,101.3687
Portugal,2013,23,56902,56273,113175,101.1178
Portugal,2013,24,57477,57073,114550,100.7079
Portugal,2013,25,57162,57172,114334,99.9825
Portugal,2013,26,57764,58198,115962,99.2543
Portugal,2013,27,59279,59864,119143,99.0228
Portugal,2013,28,63086,64316,127402,98.0876
Portugal,2013,29,64229,65837,130066,97.5576
Portugal,2013,30,66822,69839,136661,95.6801
Portugal,2013,31,67434,71017,138451,94.9547
Portugal,2013,32,70498,74567,145065,94.5432
Portugal,2013,33,70803,74756,145559,94.7121
Portugal,2013,34,72852,77669,150521,93.798
Portugal,2013,35,79559,83970,163529,94.7469
Portugal,2013,36,81324,86454,167778,94.0662
Portugal,2013,37,82079,86381,168460,95.0197
Portugal,2013,38,80381,85849,166230,93.6307
Portugal,2013,39,78458,83346,161804,94.1353
Portugal,2013,40,78694,83691,162385,94.0292
Portugal,2013,41,78258,82906,161164,94.3937
Portugal,2013,42,76218,80176,156394,95.0634
Portugal,2013,43,74540,78479,153019,94.9808
Portugal,2013,44,74268,78132,152400,95.0545
Portugal,2013,45,73754,79008,152762,93.35
Portugal,2013,46,74542,80017,154559,93.1577
Portugal,2013,47,75167,80514,155681,93.3589
Portugal,2013,48,75537,81617,157154,92.5506
Portugal,2013,49,73674,79688,153362,92.4531
Portugal,2013,50,73460,79468,152928,92.4397
Portugal,2013,51,73113,79067,152180,92.4697
Portugal,2013,52,73058,77931,150989,93.747
Portugal,2013,53,69213,74872,144085,92.4418
Portugal,2013,54,68588,74938,143526,91.5263
Portugal,2013,55,67793,73795,141588,91.8667
Portugal,2013,56,65518,71657,137175,91.4328
Portugal,2013,57,65413,72746,138159,89.9197
Portugal,2013,58,63530,70128,133658,90.5915
Portugal,2013,59,61365,68799,130164,89.1946
Portugal,2013,60,61943,70485,132428,87.8811
Portugal,2013,61,62482,69266,131748,90.2059
Portugal,2013,62,61033,68082,129115,89.6463
Portugal,2013,63,59431,66342,125773,89.5828
Portugal,2013,64,59260,68735,127995,86.2152
Portugal,2013,65,52493,61979,114472,84.6948
Portugal,2013,66,51767,62084,113851,83.3822
Portugal,2013,67,52568,64408,116976,81.6172
Portugal,2013,68,49051,60326,109377,81.3099
Portugal,2013,69,46861,57470,104331,81.5399
Portugal,2013,70,43215,53949,97164,80.1034
Portugal,2013,71,42166,52904,95070,79.7029
Portugal,2013,72,42309,53760,96069,78.6998
Portugal,2013,73,41884,54531,96415,76.8077
Portugal,2013,74,41245,53665,94910,76.8564
Portugal,2013,75,38583,52472,91055,73.5306
Portugal,2013,76,39332,53887,93219,72.9898
Portugal,2013,77,36934,52576,89510,70.2488
Portugal,2013,78,33508,48296,81804,69.3805
Portugal,2013,79,31731,47659,79390,66.5792
Portugal,2013,80,29869,45584,75453,65.5252
Portugal,2013,81,28047,42447,70494,66.0753
Portugal,2013,82,22417,36141,58558,62.0265
Portugal,2013,83,20786,34071,54857,61.0079
Portugal,2013,84,18295,32107,50402,56.9813
Portugal,2013,85,15668,28239,43907,55.4836
Portugal,2013,86,14249,27322,41571,52.1521
Portugal,2013,87,11699,23937,35636,48.8741
Portugal,2013,88,10014,20657,30671,48.4775
Portugal,2013,89,7976,17492,25468,45.598
Portugal,2013,90,6201,14255,20456,43.5005
Portugal,2013,91,4836,11529,16365,41.9464
Portugal,2013,92,3601,9574,13175,37.6123
Portugal,2013,93,2171,5971,8142,36.3591
Portugal,2013,94,1519,4380,5899,34.6804
Portugal,2013,95,1149,3432,4581,33.479
Portugal,2013,96,803,2780,3583,28.8849
Portugal,2013,97,516,1963,2479,26.2863
Portugal,2013,98,340,1388,1728,24.4957
Portugal,2013,99,205,1019,1224,20.1178
Portugal,2013,100,267,1372,1639,19.4606
Portugal,2014,0,42189,40475,82664,104.2347
Portugal,2014,1,46104,43535,89639,105.901
Portugal,2014,2,49080,46606,95686,105.3083
Portugal,2014,3,50386,49132,99518,102.5523
Portugal,2014,4,48931,47044,95975,104.0111
Portugal,2014,5,51356,48702,100058,105.4495
Portugal,2014,6,50231,47905,98136,104.8554
Portugal,2014,7,51409,49450,100859,103.9616
Portugal,2014,8,53984,50920,104904,106.0173
Portugal,2014,9,52949,50516,103465,104.8163
Portugal,2014,10,54523,51753,106276,105.3523
Portugal,2014,11,55171,52104,107275,105.8863
Portugal,2014,12,55042,51874,106916,106.1071
Portugal,2014,13,59746,56662,116408,105.4428
Portugal,2014,14,58191,55863,114054,104.1673
Portugal,2014,15,56686,54255,110941,104.4807
Portugal,2014,16,56149,54434,110583,103.1506
Portugal,2014,17,56333,53248,109581,105.7936
Portugal,2014,18,55630,52838,108468,105.2841
Portugal,2014,19,55016,52880,107896,104.0393
Portugal,2014,20,56550,55342,111892,102.1828
Portugal,2014,21,56579,55884,112463,101.2436
Portugal,2014,22,57495,56331,113826,102.0664
Portugal,2014,23,57093,56230,113323,101.5348
Portugal,2014,24,56366,55541,111907,101.4854
Portugal,2014,25,56974,56435,113409,100.9551
Portugal,2014,26,56669,56651,113320,100.0318
Portugal,2014,27,57142,57669,114811,99.0862
Portugal,2014,28,58592,59397,117989,98.6447
Portugal,2014,29,62313,63902,126215,97.5134
Portugal,2014,30,63459,65526,128985,96.8455
Portugal,2014,31,66060,69572,135632,94.952
Portugal,2014,32,66675,70819,137494,94.1485
Portugal,2014,33,69701,74374,144075,93.7169
Portugal,2014,34,70011,74574,144585,93.8812
Portugal,2014,35,72081,77515,149596,92.9897
Portugal,2014,36,78766,83810,162576,93.9816
Portugal,2014,37,80495,86290,166785,93.2843
Portugal,2014,38,81203,86201,167404,94.2019
Portugal,2014,39,79455,85645,165100,92.7725
Portugal,2014,40,77441,83134,160575,93.152
Portugal,2014,41,77654,83535,161189,92.9598
Portugal,2014,42,77267,82774,160041,93.3469
Portugal,2014,43,75284,80018,155302,94.0838
Portugal,2014,44,73612,78323,151935,93.9852
Portugal,2014,45,73292,77943,151235,94.0328
Portugal,2014,46,72727,78800,151527,92.2931
Portugal,2014,47,73598,79761,153359,92.2732
Portugal,2014,48,74266,80278,154544,92.511
Portugal,2014,49,74638,81362,156000,91.7357
Portugal,2014,50,72821,79457,152278,91.6483
Portugal,2014,51,72608,79216,151824,91.6583
Portugal,2014,52,72238,78856,151094,91.6075
Portugal,2014,53,72207,77701,149908,92.9293
Portugal,2014,54,68422,74606,143028,91.7111
Portugal,2014,55,67809,74692,142501,90.7848
Portugal,2014,56,66989,73558,140547,91.0696
Portugal,2014,57,64762,71401,136163,90.7018
Portugal,2014,58,64635,72499,137134,89.153
Portugal,2014,59,62787,69897,132684,89.8279
Portugal,2014,60,60624,68543,129167,88.4467
Portugal,2014,61,61185,70153,131338,87.2165
Portugal,2014,62,61735,68932,130667,89.5593
Portugal,2014,63,60285,67754,128039,88.9763
Portugal,2014,64,58679,65961,124640,88.9601
Portugal,2014,65,58367,68314,126681,85.4393
Portugal,2014,66,51695,61589,113284,83.9354
Portugal,2014,67,50937,61646,112583,82.6282
Portugal,2014,68,51620,63857,115477,80.8369
Portugal,2014,69,48092,59798,107890,80.4241
Portugal,2014,70,45880,56924,102804,80.5987
Portugal,2014,71,42212,53325,95537,79.1599
Portugal,2014,72,41143,52222,93365,78.7848
Portugal,2014,73,41161,52977,94138,77.696
Portugal,2014,74,40565,53642,94207,75.6217
Portugal,2014,75,39796,52613,92409,75.6391
Portugal,2014,76,37114,51334,88448,72.2991
Portugal,2014,77,37731,52566,90297,71.7783
Portugal,2014,78,35208,51170,86378,68.8059
Portugal,2014,79,31783,46799,78582,67.9138
Portugal,2014,80,29912,45994,75906,65.0346
Portugal,2014,81,27900,43719,71619,63.8166
Portugal,2014,82,26041,40506,66547,64.2892
Portugal,2014,83,20430,34006,54436,60.0776
Portugal,2014,84,18767,31822,50589,58.9749
Portugal,2014,85,16337,29709,46046,54.9901
Portugal,2014,86,13825,25828,39653,53.5272
Portugal,2014,87,12391,24755,37146,50.0545
Portugal,2014,88,10058,21393,31451,47.0154
Portugal,2014,89,8444,18250,26694,46.2685
Portugal,2014,90,6630,15135,21765,43.8057
Portugal,2014,91,5031,12137,17168,41.4518
Portugal,2014,92,3867,9679,13546,39.9525
Portugal,2014,93,2772,7852,10624,35.3031
Portugal,2014,94,1630,4828,6458,33.7614
Portugal,2014,95,1113,3457,4570,32.1955
Portugal,2014,96,824,2598,3422,31.7167
Portugal,2014,97,543,2035,2578,26.683
Portugal,2014,98,336,1462,1798,22.9822
Portugal,2014,99,234,941,1175,24.8672
Portugal,2014,100,284,1579,1863,17.9861
Portugal,2015,0,42373,39892,82265,106.2193
Portugal,2015,1,42224,40478,82702,104.3135
Portugal,2015,2,46144,43516,89660,106.0392
Portugal,2015,3,49110,46574,95684,105.4451
Portugal,2015,4,50394,49095,99489,102.6459
Portugal,2015,5,48918,47011,95929,104.0565
Portugal,2015,6,51321,48670,99991,105.4469
Portugal,2015,7,50195,47891,98086,104.8109
Portugal,2015,8,51377,49461,100838,103.8738
Portugal,2015,9,53959,50958,104917,105.8892
Portugal,2015,10,52931,50582,103513,104.6439
Portugal,2015,11,54517,51823,106340,105.1985
Portugal,2015,12,55180,52175,107355,105.7595
Portugal,2015,13,55064,51923,106987,106.0493
Portugal,2015,14,59770,56699,116469,105.4163
Portugal,2015,15,58190,55888,114078,104.119
Portugal,2015,16,56634,54253,110887,104.3887
Portugal,2015,17,56005,54402,110407,102.9466
Portugal,2015,18,56061,53141,109202,105.4948
Portugal,2015,19,55176,52619,107795,104.8595
Portugal,2015,20,54390,52521,106911,103.5586
Portugal,2015,21,55785,54853,110638,101.6991
Portugal,2015,22,55761,55308,111069,100.819
Portugal,2015,23,56715,55732,112447,101.7638
Portugal,2015,24,56385,55666,112051,101.2916
Portugal,2015,25,55734,55037,110771,101.2664
Portugal,2015,26,56388,55992,112380,100.7072
Portugal,2015,27,56093,56252,112345,99.7173
Portugal,2015,28,56562,57326,113888,98.6673
Portugal,2015,29,58017,59106,117123,98.1575
Portugal,2015,30,61717,63686,125403,96.9083
Portugal,2015,31,62852,65379,128231,96.1348
Portugal,2015,32,65446,69463,134909,94.2171
Portugal,2015,33,66055,70718,136773,93.4062
Portugal,2015,34,69068,74273,143341,92.9921
Portugal,2015,35,69339,74465,143804,93.1162
Portugal,2015,36,71381,77404,148785,92.2187
Portugal,2015,37,78035,83695,161730,93.2373
Portugal,2015,38,79741,86167,165908,92.5424
Portugal,2015,39,80410,86091,166501,93.4012
Portugal,2015,40,78628,85544,164172,91.9153
Portugal,2015,41,76595,83042,159637,92.2365
Portugal,2015,42,76781,83424,160205,92.0371
Portugal,2015,43,76361,82658,159019,92.3819
Portugal,2015,44,74363,79879,154242,93.0946
Portugal,2015,45,72695,78146,150841,93.0246
Portugal,2015,46,72357,77765,150122,93.0457
Portugal,2015,47,71801,78631,150432,91.3139
Portugal,2015,48,72730,79582,152312,91.39
Portugal,2015,49,73393,80114,153507,91.6107
Portugal,2015,50,73814,81184,154998,90.9219
Portugal,2015,51,72005,79273,151278,90.8317
Portugal,2015,52,71799,79015,150814,90.8676
Portugal,2015,53,71384,78654,150038,90.757
Portugal,2015,54,71469,77492,148961,92.2276
Portugal,2015,55,67653,74413,142066,90.9156
Portugal,2015,56,67055,74470,141525,90.043
Portugal,2015,57,66208,73350,139558,90.2631
Portugal,2015,58,64024,71209,135233,89.91
Portugal,2015,59,63909,72269,136178,88.4321
Portugal,2015,60,62061,69632,131693,89.1271
Portugal,2015,61,59959,68295,128254,87.7941
Portugal,2015,62,60459,69869,130328,86.5319
Portugal,2015,63,60982,68630,129612,88.8562
Portugal,2015,64,59538,67440,126978,88.2829
Portugal,2015,65,57918,65573,123491,88.326
Portugal,2015,66,57546,67933,125479,84.7099
Portugal,2015,67,50943,61160,112103,83.2946
Portugal,2015,68,50124,61141,111265,81.981
Portugal,2015,69,50695,63298,113993,80.0894
Portugal,2015,70,47056,59208,106264,79.4757
Portugal,2015,71,44825,56325,101150,79.5828
Portugal,2015,72,41192,52710,93902,78.1484
Portugal,2015,73,40157,51536,91693,77.9203
Portugal,2015,74,39990,52186,92176,76.6297
Portugal,2015,75,39191,52664,91855,74.4171
Portugal,2015,76,38351,51606,89957,74.315
Portugal,2015,77,35591,50180,85771,70.9267
Portugal,2015,78,36098,51186,87284,70.5232
Portugal,2015,79,33487,49706,83193,67.3701
Portugal,2015,80,30077,45213,75290,66.5229
Portugal,2015,81,27982,44178,72160,63.3392
Portugal,2015,82,25938,41722,67660,62.1686
Portugal,2015,83,24013,38468,62481,62.4233
Portugal,2015,84,18485,31786,50271,58.1545
Portugal,2015,85,16899,29496,46395,57.2925
Portugal,2015,86,14342,27330,41672,52.4771
Portugal,2015,87,12075,23531,35606,51.3153
Portugal,2015,88,10704,22164,32868,48.2945
Portugal,2015,89,8459,18893,27352,44.7732
Portugal,2015,90,7007,15877,22884,44.133
Portugal,2015,91,5412,12955,18367,41.7754
Portugal,2015,92,4059,10216,14275,39.7318
Portugal,2015,93,3016,8044,11060,37.4938
Portugal,2015,94,2105,6356,8461,33.1183
Portugal,2015,95,1213,3830,5043,31.671
Portugal,2015,96,799,2679,3478,29.8246
Portugal,2015,97,598,1964,2562,30.4481
Portugal,2015,98,381,1512,1893,25.1984
Portugal,2015,99,223,1054,1277,21.1575
Portugal,2015,100,303,1663,1966,18.2201
Portugal,2016,0,43694,41835,85529,104.4436
Portugal,2016,1,42454,39968,82422,106.22
Portugal,2016,2,42301,40549,82850,104.3207
Portugal,2016,3,46206,43571,89777,106.0476
Portugal,2016,4,49171,46619,95790,105.4742
Portugal,2016,5,50427,49131,99558,102.6378
Portugal,2016,6,48943,47048,95991,104.0278
Portugal,2016,7,51337,48710,100047,105.3931
Portugal,2016,8,50223,47953,98176,104.7338
Portugal,2016,9,51405,49526,100931,103.794
Portugal,2016,10,53987,51043,105030,105.7677
Portugal,2016,11,52967,50680,103647,104.5126
Portugal,2016,12,54565,51926,106491,105.0822
Portugal,2016,13,55225,52256,107481,105.6816
Portugal,2016,14,55107,51993,107100,105.9893
Portugal,2016,15,59776,56746,116522,105.3396
Portugal,2016,16,58165,55916,114081,104.0221
Portugal,2016,17,56524,54237,110761,104.2167
Portugal,2016,18,55824,54379,110203,102.6573
Portugal,2016,19,55757,53039,108796,105.1245
Portugal,2016,20,54780,52479,107259,104.3846
Portugal,2016,21,53927,52307,106234,103.0971
Portugal,2016,22,55262,54590,109852,101.231
Portugal,2016,23,55234,54970,110204,100.4803
Portugal,2016,24,56191,55396,111587,101.4351
Portugal,2016,25,55847,55345,111192,100.907
Portugal,2016,26,55186,54756,109942,100.7853
Portugal,2016,27,55856,55722,111578,100.2405
Portugal,2016,28,55540,56001,111541,99.1768
Portugal,2016,29,56036,57163,113199,98.0284
Portugal,2016,30,57481,59016,116497,97.399
Portugal,2016,31,61201,63650,124851,96.1524
Portugal,2016,32,62354,65413,127767,95.3236
Portugal,2016,33,64983,69507,134490,93.4913
Portugal,2016,34,65626,70809,136435,92.6803
Portugal,2016,35,68688,74318,143006,92.4244
Portugal,2016,36,68965,74499,143464,92.5717
Portugal,2016,37,71030,77397,148427,91.7736
Portugal,2016,38,77636,83668,161304,92.7906
Portugal,2016,39,79318,86124,165442,92.0974
Portugal,2016,40,79971,86071,166042,92.9128
Portugal,2016,41,78158,85539,163697,91.3712
Portugal,2016,42,76099,83060,159159,91.6193
Portugal,2016,43,76289,83402,159691,91.4714
Portugal,2016,44,75873,82629,158502,91.8237
Portugal,2016,45,73818,79822,153640,92.4783
Portugal,2016,46,72160,78042,150202,92.463
Portugal,2016,47,71798,77672,149470,92.4374
Portugal,2016,48,71232,78515,149747,90.7241
Portugal,2016,49,72233,79516,151749,90.8408
Portugal,2016,50,72909,80034,152943,91.0975
Portugal,2016,51,73304,81112,154416,90.3738
Portugal,2016,52,71542,79170,150712,90.365
Portugal,2016,53,71245,78891,150136,90.3081
Portugal,2016,54,70834,78516,149350,90.216
Portugal,2016,55,70853,77399,148252,91.5425
Portugal,2016,56,67028,74266,141294,90.254
Portugal,2016,57,66490,74335,140825,89.4464
Portugal,2016,58,65609,73238,138847,89.5833
Portugal,2016,59,63439,71066,134505,89.2677
Portugal,2016,60,63314,72103,135417,87.8105
Portugal,2016,61,61418,69421,130839,88.4718
Portugal,2016,62,59351,68066,127417,87.1963
Portugal,2016,63,59801,69609,129410,85.9099
Portugal,2016,64,60366,68388,128754,88.2699
Portugal,2016,65,58878,67184,126062,87.6369
Portugal,2016,66,57184,65244,122428,87.6464
Portugal,2016,67,56758,67575,124333,83.9926
Portugal,2016,68,50211,60783,110994,82.607
Portugal,2016,69,49219,60692,109911,81.0964
Portugal,2016,70,49731,62747,112478,79.2564
Portugal,2016,71,46013,58643,104656,78.4629
Portugal,2016,72,43774,55685,99459,78.61
Portugal,2016,73,40119,52058,92177,77.066
Portugal,2016,74,39030,50826,89856,76.7914
Portugal,2016,75,38750,51354,90104,75.4566
Portugal,2016,76,37836,51689,89525,73.1993
Portugal,2016,77,36870,50520,87390,72.981
Portugal,2016,78,33937,48951,82888,69.3285
Portugal,2016,79,34348,49733,84081,69.0648
Portugal,2016,80,31657,48057,79714,65.8739
Portugal,2016,81,28250,43444,71694,65.0262
Portugal,2016,82,26031,42169,68200,61.7302
Portugal,2016,83,23865,39449,63314,60.4958
Portugal,2016,84,21970,36178,58148,60.7275
Portugal,2016,85,16483,29353,45836,56.1544
Portugal,2016,86,14955,26925,41880,55.5432
Portugal,2016,87,12504,24705,37209,50.6132
Portugal,2016,88,10355,21027,31382,49.2462
Portugal,2016,89,9057,19507,28564,46.4295
Portugal,2016,90,6984,16403,23387,42.5776
Portugal,2016,91,5701,13538,19239,42.1111
Portugal,2016,92,4286,10788,15074,39.7293
Portugal,2016,93,3149,8319,11468,37.8531
Portugal,2016,94,2298,6422,8720,35.7832
Portugal,2016,95,1547,4944,6491,31.2905
Portugal,2016,96,905,2907,3812,31.1318
Portugal,2016,97,567,1991,2558,28.4782
Portugal,2016,98,405,1400,1805,28.9286
Portugal,2016,99,252,1054,1306,23.9089
Portugal,2016,100,325,1731,2056,18.7753
Portugal,2017,0,44760,42317,87077,105.7731
Portugal,2017,1,43781,41921,85702,104.4369
Portugal,2017,2,42534,40038,82572,106.2341
Portugal,2017,3,42377,40623,83000,104.3178
Portugal,2017,4,46267,43631,89898,106.0416
Portugal,2017,5,49223,46651,95874,105.5133
Portugal,2017,6,50481,49169,99650,102.6683
Portugal,2017,7,48986,47094,96080,104.0175
Portugal,2017,8,51377,48754,100131,105.3801
Portugal,2017,9,50255,48012,98267,104.6717
Portugal,2017,10,51436,49594,101030,103.7142
Portugal,2017,11,54025,51117,105142,105.6889
Portugal,2017,12,53012,50769,103781,104.4181
Portugal,2017,13,54608,52004,106612,105.0073
Portugal,2017,14,55269,52324,107593,105.6284
Portugal,2017,15,55134,52072,107206,105.8803
Portugal,2017,16,59760,56779,116539,105.2502
Portugal,2017,17,58092,55875,113967,103.9678
Portugal,2017,18,56417,54168,110585,104.1519
Portugal,2017,19,55619,54243,109862,102.5367
Portugal,2017,20,55453,52802,108255,105.0206
Portugal,2017,21,54414,52161,106575,104.3193
Portugal,2017,22,53505,51911,105416,103.0706
Portugal,2017,23,54814,54190,109004,101.1515
Portugal,2017,24,54767,54543,109310,100.4107
Portugal,2017,25,55725,54969,110694,101.3753
Portugal,2017,26,55381,54951,110332,100.7825
Portugal,2017,27,54770,54395,109165,100.6894
Portugal,2017,28,55443,55397,110840,100.083
Portugal,2017,29,55135,55755,110890,98.888
Portugal,2017,30,55650,57024,112674,97.5905
Portugal,2017,31,57086,58948,116034,96.8413
Portugal,2017,32,60799,63651,124450,95.5193
Portugal,2017,33,62017,65451,127468,94.7533
Portugal,2017,34,64680,69546,134226,93.0032
Portugal,2017,35,65369,70830,136199,92.29
Portugal,2017,36,68471,74326,142797,92.1225
Portugal,2017,37,68761,74457,143218,92.3499
Portugal,2017,38,70765,77345,148110,91.4927
Portugal,2017,39,77315,83589,160904,92.4942
Portugal,2017,40,78943,86058,165001,91.7323
Portugal,2017,41,79559,86006,165565,92.504
Portugal,2017,42,77736,85490,163226,90.9299
Portugal,2017,43,75684,83025,158709,91.1581
Portugal,2017,44,75861,83360,159221,91.0041
Portugal,2017,45,75404,82561,157965,91.3313
Portugal,2017,46,73382,79755,153137,92.0093
Portugal,2017,47,71735,77970,149705,92.0033
Portugal,2017,48,71363,77588,148951,91.9769
Portugal,2017,49,70789,78437,149226,90.2495
Portugal,2017,50,71794,79426,151220,90.3911
Portugal,2017,51,72463,79954,152417,90.6309
Portugal,2017,52,72763,81000,153763,89.8309
Portugal,2017,53,70988,79049,150037,89.8025
Portugal,2017,54,70693,78750,149443,89.7689
Portugal,2017,55,70264,78372,148636,89.6545
Portugal,2017,56,70247,77262,147509,90.9205
Portugal,2017,57,66390,74128,140518,89.5613
Portugal,2017,58,65884,74162,140046,88.8379
Portugal,2017,59,65005,73094,138099,88.9334
Portugal,2017,60,62856,70904,133760,88.6494
Portugal,2017,61,62689,71910,134599,87.177
Portugal,2017,62,60783,69224,130007,87.8063
Portugal,2017,63,58697,67859,126556,86.4985
Portugal,2017,64,59119,69339,128458,85.2608
Portugal,2017,65,59653,68148,127801,87.5345
Portugal,2017,66,58120,66885,125005,86.8954
Portugal,2017,67,56351,64921,121272,86.7993
Portugal,2017,68,55814,67151,122965,83.1172
Portugal,2017,69,49378,60352,109730,81.8167
Portugal,2017,70,48274,60151,108425,80.2547
Portugal,2017,71,48769,62177,110946,78.4358
Portugal,2017,72,44967,57964,102931,77.5775
Portugal,2017,73,42661,54988,97649,77.5824
Portugal,2017,74,38969,51317,90286,75.9378
Portugal,2017,75,37753,50056,87809,75.4215
Portugal,2017,76,37404,50415,87819,74.1922
Portugal,2017,77,36314,50547,86861,71.842
Portugal,2017,78,35204,49275,84479,71.4439
Portugal,2017,79,32207,47502,79709,67.8014
Portugal,2017,80,32484,48159,80643,67.4516
Portugal,2017,81,29779,46280,76059,64.3453
Portugal,2017,82,26278,41525,67803,63.2824
Portugal,2017,83,23959,40021,63980,59.8661
Portugal,2017,84,21702,37115,58817,58.4723
Portugal,2017,85,19868,33858,53726,58.6804
Portugal,2017,86,14517,26798,41315,54.172
Portugal,2017,87,12982,24387,37369,53.2333
Portugal,2017,88,10688,21975,32663,48.6371
Portugal,2017,89,8652,18551,27203,46.639
Portugal,2017,90,7520,16887,24407,44.5313
Portugal,2017,91,5677,13897,19574,40.8505
Portugal,2017,92,4531,11275,15806,40.1863
Portugal,2017,93,3330,8853,12183,37.6144
Portugal,2017,94,2397,6711,9108,35.7175
Portugal,2017,95,1681,5038,6719,33.3664
Portugal,2017,96,1135,3753,4888,30.2425
Portugal,2017,97,630,2174,2804,28.9788
Portugal,2017,98,388,1413,1801,27.4593
Portugal,2017,99,256,978,1234,26.1759
Portugal,2017,100,352,1793,2145,19.6319
Portugal,2018,0,44063,42194,86257,104.4295
Portugal,2018,1,44834,42486,87320,105.5265
Portugal,2018,2,43874,42087,85961,104.246
Portugal,2018,3,42633,40189,82822,106.0813
Portugal,2018,4,42466,40744,83210,104.2264
Portugal,2018,5,46353,43744,90097,105.9642
Portugal,2018,6,49306,46770,96076,105.4223
Portugal,2018,7,50565,49282,99847,102.6034
Portugal,2018,8,49053,47216,96269,103.8906
Portugal,2018,9,51441,48882,100323,105.2351
Portugal,2018,10,50303,48145,98448,104.4823
Portugal,2018,11,51485,49719,101204,103.552
Portugal,2018,12,54080,51252,105332,105.5178
Portugal,2018,13,53056,50894,103950,104.248
Portugal,2018,14,54638,52137,106775,104.797
Portugal,2018,15,55282,52446,107728,105.4075
Portugal,2018,16,55091,52178,107269,105.5828
Portugal,2018,17,59668,56843,116511,104.9698
Portugal,2018,18,57984,55928,113912,103.6762
Portugal,2018,19,56271,54215,110486,103.7923
Portugal,2018,20,55387,54218,109605,102.1561
Portugal,2018,21,55153,52745,107898,104.5654
Portugal,2018,22,54095,52057,106152,103.9149
Portugal,2018,23,53162,51844,105006,102.5422
Portugal,2018,24,54468,54159,108627,100.5705
Portugal,2018,25,54449,54543,108992,99.8277
Portugal,2018,26,55446,55024,110470,100.7669
Portugal,2018,27,55140,55034,110174,100.1926
Portugal,2018,28,54546,54521,109067,100.0459
Portugal,2018,29,55214,55554,110768,99.388
Portugal,2018,30,54901,55959,110860,98.1093
Portugal,2018,31,55431,57278,112709,96.7754
Portugal,2018,32,56863,59222,116085,96.0167
Portugal,2018,33,60594,63934,124528,94.7759
Portugal,2018,34,61886,65744,127630,94.1318
Portugal,2018,35,64572,69834,134406,92.465
Portugal,2018,36,65282,71069,136351,91.8572
Portugal,2018,37,68385,74512,142897,91.7772
Portugal,2018,38,68636,74582,143218,92.0276
Portugal,2018,39,70594,77433,148027,91.1678
Portugal,2018,40,77075,83668,160743,92.12
Portugal,2018,41,78633,86093,164726,91.335
Portugal,2018,42,79265,86033,165298,92.1333
Portugal,2018,43,77405,85498,162903,90.5343
Portugal,2018,44,75362,83018,158380,90.7779
Portugal,2018,45,75507,83363,158870,90.5762
Portugal,2018,46,75067,82551,157618,90.9341
Portugal,2018,47,73040,79760,152800,91.5747
Portugal,2018,48,71344,77956,149300,91.5183
Portugal,2018,49,70953,77569,148522,91.4708
Portugal,2018,50,70352,78388,148740,89.7484
Portugal,2018,51,71311,79367,150678,89.8497
Portugal,2018,52,71944,79851,151795,90.0978
Portugal,2018,53,72215,80881,153096,89.2855
Portugal,2018,54,70421,78920,149341,89.2309
Portugal,2018,55,70102,78616,148718,89.1701
Portugal,2018,56,69651,78247,147898,89.0143
Portugal,2018,57,69632,77185,146817,90.2144
Portugal,2018,58,65783,74017,139800,88.8755
Portugal,2018,59,65296,74033,139329,88.1985
Portugal,2018,60,64392,72931,137323,88.2917
Portugal,2018,61,62314,70750,133064,88.0763
Portugal,2018,62,62098,71744,133842,86.555
Portugal,2018,63,60188,69005,129193,87.2227
Portugal,2018,64,58061,67610,125671,85.8763
Portugal,2018,65,58494,69075,127569,84.6819
Portugal,2018,66,58919,67852,126771,86.8346
Portugal,2018,67,57415,66536,123951,86.2916
Portugal,2018,68,55508,64514,120022,86.0402
Portugal,2018,69,54902,66644,121546,82.381
Portugal,2018,70,48546,59890,108436,81.0586
Portugal,2018,71,47350,59633,106983,79.4023
Portugal,2018,72,47746,61516,109262,77.6156
Portugal,2018,73,43842,57272,101114,76.5505
Portugal,2018,74,41462,54242,95704,76.4389
Portugal,2018,75,37777,50495,88272,74.8133
Portugal,2018,76,36541,49180,85721,74.3005
Portugal,2018,77,35996,49403,85399,72.862
Portugal,2018,78,34771,49335,84106,70.4794
Portugal,2018,79,33556,47934,81490,70.0046
Portugal,2018,80,30510,45949,76459,66.3997
Portugal,2018,81,30600,46494,77094,65.8149
Portugal,2018,82,27801,44457,72258,62.5346
Portugal,2018,83,24294,39494,63788,61.5131
Portugal,2018,84,21884,37862,59746,57.7994
Portugal,2018,85,19604,34668,54272,56.5478
Portugal,2018,86,17844,31278,49122,57.0497
Portugal,2018,87,12531,24224,36755,51.7297
Portugal,2018,88,11120,21804,32924,50.9998
Portugal,2018,89,9018,19380,28398,46.5325
Portugal,2018,90,7127,16062,23189,44.3718
Portugal,2018,91,6059,14349,20408,42.2259
Portugal,2018,92,4492,11568,16060,38.8313
Portugal,2018,93,3555,9237,12792,38.4865
Portugal,2018,94,2561,7113,9674,36.0045
Portugal,2018,95,1750,5313,7063,32.9381
Portugal,2018,96,1219,3854,5073,31.6295
Portugal,2018,97,802,2824,3626,28.3994
Portugal,2018,98,423,1601,2024,26.421
Portugal,2018,99,261,1009,1270,25.8672
Portugal,2018,100,366,1784,2150,20.5157
Portugal,2019,0,44223,42744,86967,103.4601
Portugal,2019,1,44140,42392,86532,104.1234
Portugal,2019,2,44930,42673,87603,105.2891
Portugal,2019,3,43977,42276,86253,104.0236
Portugal,2019,4,42747,40367,83114,105.8959
Portugal,2019,5,42574,40916,83490,104.0522
Portugal,2019,6,46465,43898,90363,105.8476
Portugal,2019,7,49397,46923,96320,105.2725
Portugal,2019,8,50658,49432,100090,102.4802
Portugal,2019,9,49124,47370,96494,103.7028
Portugal,2019,10,51516,49034,100550,105.0618
Portugal,2019,11,50386,48304,98690,104.3102
Portugal,2019,12,51562,49866,101428,103.4011
Portugal,2019,13,54144,51398,105542,105.3426
Portugal,2019,14,53099,51029,104128,104.0565
Portugal,2019,15,54655,52287,106942,104.5289
Portugal,2019,16,55259,52566,107825,105.1231
Portugal,2019,17,55005,52329,107334,105.1138
Portugal,2019,18,59556,57042,116598,104.4073
Portugal,2019,19,57847,56190,114037,102.9489
Portugal,2019,20,56065,54434,110499,102.9963
Portugal,2019,21,55123,54395,109518,101.3384
Portugal,2019,22,54880,52878,107758,103.7861
Portugal,2019,23,53808,52213,106021,103.0548
Portugal,2019,24,52851,52055,104906,101.5292
Portugal,2019,25,54161,54363,108524,99.6284
Portugal,2019,26,54141,54817,108958,98.7668
Portugal,2019,27,55146,55319,110465,99.6873
Portugal,2019,28,54882,55346,110228,99.1616
Portugal,2019,29,54297,54867,109164,98.9611
Portugal,2019,30,54988,55905,110893,98.3597
Portugal,2019,31,54738,56307,111045,97.2135
Portugal,2019,32,55323,57661,112984,95.9453
Portugal,2019,33,56786,59576,116362,95.3169
Portugal,2019,34,60537,64298,124835,94.1507
Portugal,2019,35,61851,66104,127955,93.5662
Portugal,2019,36,64578,70137,134715,92.0741
Portugal,2019,37,65268,71382,136650,91.4348
Portugal,2019,38,68337,74747,143084,91.4244
Portugal,2019,39,68554,74800,143354,91.6497
Portugal,2019,40,70441,77609,148050,90.764
Portugal,2019,41,76864,83834,160698,91.686
Portugal,2019,42,78366,86216,164582,90.895
Portugal,2019,43,78949,86141,165090,91.6509
Portugal,2019,44,77079,85602,162681,90.0435
Portugal,2019,45,75008,83106,158114,90.2558
Portugal,2019,46,75132,83466,158598,90.0151
Portugal,2019,47,74662,82609,157271,90.38
Portugal,2019,48,72664,79801,152465,91.0565
Portugal,2019,49,70925,78008,148933,90.9202
Portugal,2019,50,70521,77578,148099,90.9033
Portugal,2019,51,69854,78359,148213,89.1461
Portugal,2019,52,70779,79316,150095,89.2367
Portugal,2019,53,71330,79811,151141,89.3736
Portugal,2019,54,71604,80831,152435,88.5848
Portugal,2019,55,69762,78844,148606,88.4811
Portugal,2019,56,69462,78545,148007,88.4359
Portugal,2019,57,68999,78152,147151,88.2882
Portugal,2019,58,69004,77084,146088,89.5179
Portugal,2019,59,65188,73901,139089,88.2099
Portugal,2019,60,64696,73907,138603,87.537
Portugal,2019,61,63763,72781,136544,87.6094
Portugal,2019,62,61669,70589,132258,87.3635
Portugal,2019,63,61477,71572,133049,85.8953
Portugal,2019,64,59494,68808,128302,86.4638
Portugal,2019,65,57318,67376,124694,85.0718
Portugal,2019,66,57807,68779,126586,84.0475
Portugal,2019,67,58080,67504,125584,86.0393
Portugal,2019,68,56510,66184,122694,85.3832
Portugal,2019,69,54572,64020,118592,85.2421
Portugal,2019,70,53902,66119,120021,81.5227
Portugal,2019,71,47511,59375,106886,80.0185
Portugal,2019,72,46197,58987,105184,78.3173
Portugal,2019,73,46558,60783,107341,76.5971
Portugal,2019,74,42553,56443,98996,75.3911
Portugal,2019,75,40158,53343,93501,75.2826
Portugal,2019,76,36499,49538,86037,73.6788
Portugal,2019,77,35115,48067,83182,73.0543
Portugal,2019,78,34431,48186,82617,71.4544
Portugal,2019,79,32956,47854,80810,68.8678
Portugal,2019,80,31792,46347,78139,68.5956
Portugal,2019,81,28543,44124,72667,64.6882
Portugal,2019,82,28508,44439,72947,64.1509
Portugal,2019,83,25699,42315,68014,60.7326
Portugal,2019,84,22242,37171,59413,59.837
Portugal,2019,85,19709,35312,55021,55.8139
Portugal,2019,86,17510,32035,49545,54.659
Portugal,2019,87,15847,28652,44499,55.3085
Portugal,2019,88,10656,21563,32219,49.418
Portugal,2019,89,9299,19119,28418,48.6375
Portugal,2019,90,7350,16719,24069,43.962
Portugal,2019,91,5783,13520,19303,42.7737
Portugal,2019,92,4740,11968,16708,39.6056
Portugal,2019,93,3428,9461,12889,36.233
Portugal,2019,94,2701,7383,10084,36.584
Portugal,2019,95,1858,5485,7343,33.8742
Portugal,2019,96,1276,4076,5352,31.3052
Portugal,2019,97,816,2835,3651,28.7831
Portugal,2019,98,549,2047,2596,26.8197
Portugal,2019,99,270,1084,1354,24.9077
Portugal,2019,100,365,1746,2111,20.9049
Portugal,2020,0,44619,42219,86838,105.6846
Portugal,2020,1,44417,43014,87431,103.2617
Portugal,2020,2,44360,42665,87025,103.9728
Portugal,2020,3,45164,42955,88119,105.1426
Portugal,2020,4,44224,42576,86800,103.8707
Portugal,2020,5,42993,40655,83648,105.7508
Portugal,2020,6,42812,41203,84015,103.9051
Portugal,2020,7,46674,44154,90828,105.7073
Portugal,2020,8,49612,47189,96801,105.1347
Portugal,2020,9,50854,49698,100552,102.326
Portugal,2020,10,49318,47621,96939,103.5636
Portugal,2020,11,51703,49265,100968,104.9487
Portugal,2020,12,50605,48545,99150,104.2435
Portugal,2020,13,51779,50107,101886,103.3369
Portugal,2020,14,54351,51637,105988,105.2559
Portugal,2020,15,53280,51290,104570,103.8799
Portugal,2020,16,54809,52510,107319,104.3782
Portugal,2020,17,55400,52771,108171,104.9819
Portugal,2020,18,55266,52741,108007,104.7875
Portugal,2020,19,59788,57460,117248,104.0515
Portugal,2020,20,58078,56550,114628,102.702
Portugal,2020,21,56259,54726,110985,102.8012
Portugal,2020,22,55347,54618,109965,101.3347
Portugal,2020,23,55107,53155,108262,103.6723
Portugal,2020,24,54070,52533,106603,102.9258
Portugal,2020,25,53167,52414,105581,101.4366
Portugal,2020,26,54493,54869,109362,99.3147
Portugal,2020,27,54517,55358,109875,98.4808
Portugal,2020,28,55583,55927,111510,99.3849
Portugal,2020,29,55323,56038,111361,98.7241
Portugal,2020,30,54822,55574,110396,98.6468
Portugal,2020,31,55494,56653,112147,97.9542
Portugal,2020,32,55259,57045,112304,96.8691
Portugal,2020,33,55840,58388,114228,95.6361
Portugal,2020,34,57284,60234,117518,95.1024
Portugal,2020,35,61085,64969,126054,94.0218
Portugal,2020,36,62401,66780,129181,93.4426
Portugal,2020,37,65091,70654,135745,92.1264
Portugal,2020,38,65729,71819,137548,91.5203
Portugal,2020,39,68732,75166,143898,91.4403
Portugal,2020,40,68846,75164,144010,91.5944
Portugal,2020,41,70688,77932,148620,90.7047
Portugal,2020,42,77034,84141,161175,91.5535
Portugal,2020,43,78474,86508,164982,90.713
Portugal,2020,44,79004,86411,165415,91.4282
Portugal,2020,45,77102,85839,162941,89.8216
Portugal,2020,46,74972,83328,158300,89.9722
Portugal,2020,47,75062,83686,158748,89.6948
Portugal,2020,48,74520,82763,157283,90.0402
Portugal,2020,49,72508,79952,152460,90.6894
Portugal,2020,50,70723,78107,148830,90.5463
Portugal,2020,51,70250,77667,147917,90.4503
Portugal,2020,52,69538,78375,147913,88.7247
Portugal,2020,53,70375,79343,149718,88.6972
Portugal,2020,54,70932,79876,150808,88.8026
Portugal,2020,55,71155,80845,152000,88.0141
Portugal,2020,56,69315,78871,148186,87.884
Portugal,2020,57,69041,78551,147592,87.8932
Portugal,2020,58,68570,78175,146745,87.7135
Portugal,2020,59,68550,77060,145610,88.9567
Portugal,2020,60,64741,73884,138625,87.6252
Portugal,2020,61,64244,73903,138147,86.9302
Portugal,2020,62,63278,72746,136024,86.9849
Portugal,2020,63,61119,70541,131660,86.6432
Portugal,2020,64,60866,71451,132317,85.1857
Portugal,2020,65,58886,68626,127512,85.8071
Portugal,2020,66,56589,67239,123828,84.161
Portugal,2020,67,57039,68545,125584,83.2139
Portugal,2020,68,57281,67204,124485,85.2345
Portugal,2020,69,55658,65818,121476,84.5635
Portugal,2020,70,53556,63548,117104,84.2765
Portugal,2020,71,52884,65585,118469,80.6343
Portugal,2020,72,46505,58775,105280,79.1238
Portugal,2020,73,45062,58310,103372,77.2801
Portugal,2020,74,45378,59979,105357,75.6565
Portugal,2020,75,41266,55606,96872,74.2114
Portugal,2020,76,38779,52377,91156,74.0382
Portugal,2020,77,35167,48548,83715,72.4376
Portugal,2020,78,33743,46937,80680,71.89
Portugal,2020,79,32835,46789,79624,70.1768
Portugal,2020,80,31186,46239,77425,67.4452
Portugal,2020,81,29999,44669,74668,67.1584
Portugal,2020,82,26592,42200,68792,63.0142
Portugal,2020,83,26442,42308,68750,62.4988
Portugal,2020,84,23571,40042,63613,58.8657
Portugal,2020,85,20190,34706,54896,58.1744
Portugal,2020,86,17570,32666,50236,53.7868
Portugal,2020,87,15603,29361,44964,53.1419
Portugal,2020,88,14037,26053,40090,53.8786
Portugal,2020,89,8930,19008,27938,46.9802
Portugal,2020,90,7615,16496,24111,46.1627
Portugal,2020,91,5896,14147,20043,41.6767
Portugal,2020,92,4553,11280,15833,40.3635
Portugal,2020,93,3684,9758,13442,37.7536
Portugal,2020,94,2569,7572,10141,33.9276
Portugal,2020,95,1911,5764,7675,33.1541
Portugal,2020,96,1312,4145,5457,31.6526
Portugal,2020,97,879,2966,3845,29.6359
Portugal,2020,98,555,2022,2577,27.4481
Portugal,2020,99,358,1425,1783,25.1228
Portugal,2020,100,366,1760,2126,20.7955
Portugal,2021,0,43425,41180,84605,105.4517
Portugal,2021,1,44785,42475,87260,105.4385
Portugal,2021,2,44617,43297,87914,103.0487
Portugal,2021,3,44592,42975,87567,103.7627
Portugal,2021,4,45425,43272,88697,104.9755
Portugal,2021,5,44496,42874,87370,103.7832
Portugal,2021,6,43263,40930,84193,105.7
Portugal,2021,7,43062,41485,84547,103.8014
Portugal,2021,8,46915,44407,91322,105.6478
Portugal,2021,9,49847,47427,97274,105.1026
Portugal,2021,10,51107,49917,101024,102.384
Portugal,2021,11,49573,47862,97435,103.5749
Portugal,2021,12,51959,49504,101463,104.9592
Portugal,2021,13,50838,48768,99606,104.2446
Portugal,2021,14,52018,50335,102353,103.3436
Portugal,2021,15,54560,51881,106441,105.1637
Portugal,2021,16,53432,51515,104947,103.7212
Portugal,2021,17,54927,52738,107665,104.1507
Portugal,2021,18,55595,53185,108780,104.5314
Portugal,2021,19,55464,53133,108597,104.3871
Portugal,2021,20,59956,57818,117774,103.6978
Portugal,2021,21,58253,56856,115109,102.4571
Portugal,2021,22,56453,55022,111475,102.6008
Portugal,2021,23,55585,54953,110538,101.1501
Portugal,2021,24,55341,53556,108897,103.333
Portugal,2021,25,54320,53008,107328,102.4751
Portugal,2021,26,53479,52933,106412,101.0315
Portugal,2021,27,54878,55454,110332,98.9613
Portugal,2021,28,54916,55974,110890,98.1098
Portugal,2021,29,56034,56600,112634,99
Portugal,2021,30,55825,56751,112576,98.3683
Portugal,2021,31,55366,56272,111638,98.39
Portugal,2021,32,55956,57328,113284,97.6068
Portugal,2021,33,55718,57698,113416,96.5683
Portugal,2021,34,56314,59024,115338,95.4086
Portugal,2021,35,57747,60791,118538,94.9927
Portugal,2021,36,61559,65505,127064,93.976
Portugal,2021,37,62833,67261,130094,93.4167
Portugal,2021,38,65479,71093,136572,92.1033
Portugal,2021,39,65816,72152,137968,91.2185
Portugal,2021,40,68964,75519,144483,91.3201
Portugal,2021,41,69018,75495,144513,91.4206
Portugal,2021,42,70779,78202,148981,90.5079
Portugal,2021,43,77053,84414,161467,91.2799
Portugal,2021,44,78445,86755,165200,90.4213
Portugal,2021,45,78916,86648,165564,91.0765
Portugal,2021,46,76974,86051,163025,89.4516
Portugal,2021,47,74843,83510,158353,89.6216
Portugal,2021,48,74862,83859,158721,89.2713
Portugal,2021,49,74258,82898,157156,89.5776
Portugal,2021,50,72201,80020,152221,90.2287
Portugal,2021,51,70396,78128,148524,90.1034
Portugal,2021,52,69849,77686,147535,89.912
Portugal,2021,53,69080,78382,147462,88.1325
Portugal,2021,54,69924,79356,149280,88.1143
Portugal,2021,55,70438,79896,150334,88.1621
Portugal,2021,56,70665,80874,151539,87.3767
Portugal,2021,57,68791,78878,147669,87.2119
Portugal,2021,58,68489,78555,147044,87.186
Portugal,2021,59,68010,78128,146138,87.0495
Portugal,2021,60,68019,77032,145051,88.2997
Portugal,2021,61,64145,73802,137947,86.915
Portugal,2021,62,63638,73814,137452,86.214
Portugal,2021,63,62651,72573,135224,86.3282
Portugal,2021,64,60418,70346,130764,85.8869
Portugal,2021,65,60150,71215,131365,84.4625
Portugal,2021,66,58134,68335,126469,85.0721
Portugal,2021,67,55706,66893,122599,83.2763
Portugal,2021,68,56173,68160,124333,82.4134
Portugal,2021,69,56316,66742,123058,84.3787
Portugal,2021,70,54645,65332,119977,83.642
Portugal,2021,71,52380,62967,115347,83.1864
Portugal,2021,72,51695,64860,116555,79.7024
Portugal,2021,73,45273,57980,103253,78.0838
Portugal,2021,74,43693,57428,101121,76.0831
Portugal,2021,75,43929,58968,102897,74.4963
Portugal,2021,76,39773,54501,94274,72.9766
Portugal,2021,77,37173,51154,88327,72.6688
Portugal,2021,78,33584,47261,80845,71.0607
Portugal,2021,79,32102,45488,77590,70.5725
Portugal,2021,80,30941,45185,76126,68.4763
Portugal,2021,81,29194,44251,73445,65.9737
Portugal,2021,82,27826,42578,70404,65.353
Portugal,2021,83,24432,39911,64343,61.2162
Portugal,2021,84,24045,39706,63751,60.5576
Portugal,2021,85,21271,37457,58728,56.7878
Portugal,2021,86,17975,31944,49919,56.2703
Portugal,2021,87,15329,29658,44987,51.6859
Portugal,2021,88,13465,26265,39730,51.2659
Portugal,2021,89,12086,23086,35172,52.3521
Portugal,2021,90,7089,16060,23149,44.1407
Portugal,2021,91,5913,13615,19528,43.43
Portugal,2021,92,4511,11483,15994,39.2842
Portugal,2021,93,3379,8953,12332,37.7415
Portugal,2021,94,2666,7570,10236,35.218
Portugal,2021,95,1801,5740,7541,31.3763
Portugal,2021,96,1320,4245,5565,31.0954
Portugal,2021,97,861,3003,3864,28.6713
Portugal,2021,98,559,2025,2584,27.6049
Portugal,2021,99,355,1368,1723,25.9503
Portugal,2021,100,385,1884,2269,20.4352
Portugal,2022,0,41399,39333,80732,105.2526
Portugal,2022,1,43587,41344,84931,105.4252
Portugal,2022,2,44934,42622,87556,105.4244
Portugal,2022,3,44744,43423,88167,103.0422
Portugal,2022,4,44700,43084,87784,103.7508
Portugal,2022,5,45518,43368,88886,104.9576
Portugal,2022,6,44574,42955,87529,103.7691
Portugal,2022,7,43330,40999,84329,105.6855
Portugal,2022,8,43118,41544,84662,103.7888
Portugal,2022,9,46962,44457,91419,105.6347
Portugal,2022,10,49889,47470,97359,105.0959
Portugal,2022,11,51149,49961,101110,102.3779
Portugal,2022,12,49624,47917,97541,103.5624
Portugal,2022,13,52031,49582,101613,104.9393
Portugal,2022,14,50942,48888,99830,104.2014
Portugal,2022,15,52170,50508,102678,103.2906
Portugal,2022,16,54769,52118,106887,105.0865
Portugal,2022,17,53706,51822,105528,103.6355
Portugal,2022,18,55263,53114,108377,104.046
Portugal,2022,19,55984,53622,109606,104.4049
Portugal,2022,20,55901,53618,109519,104.2579
Portugal,2022,21,60427,58339,118766,103.5791
Portugal,2022,22,58746,57399,116145,102.3467
Portugal,2022,23,56961,55572,112533,102.4995
Portugal,2022,24,56094,55504,111598,101.063
Portugal,2022,25,55844,54099,109943,103.2256
Portugal,2022,26,54807,53534,108341,102.3779
Portugal,2022,27,53947,53436,107383,100.9563
Portugal,2022,28,55324,55930,111254,98.9165
Portugal,2022,29,55335,56421,111756,98.0752
Portugal,2022,30,56424,57013,113437,98.9669
Portugal,2022,31,56187,57131,113318,98.3477
Portugal,2022,32,55707,56623,112330,98.3823
Portugal,2022,33,56269,57645,113914,97.613
Portugal,2022,34,55995,57983,113978,96.5714
Portugal,2022,35,56563,59284,115847,95.4102
Portugal,2022,36,57978,61033,119011,94.9945
Portugal,2022,37,61763,65721,127484,93.9776
Portugal,2022,38,63012,67446,130458,93.4259
Portugal,2022,39,65623,71250,136873,92.1025
Portugal,2022,40,65926,72293,138219,91.1928
Portugal,2022,41,69048,75639,144687,91.2862
Portugal,2022,42,69089,75593,144682,91.396
Portugal,2022,43,70823,78279,149102,90.4751
Portugal,2022,44,77051,84458,161509,91.23
Portugal,2022,45,78410,86773,165183,90.3622
Portugal,2022,46,78836,86650,165486,90.9821
Portugal,2022,47,76863,86041,162904,89.333
Portugal,2022,48,74701,83476,158177,89.488
Portugal,2022,49,74692,83803,158495,89.1281
Portugal,2022,50,74068,82826,156894,89.426
Portugal,2022,51,71964,79948,151912,90.0135
Portugal,2022,52,70106,78031,148137,89.8438
Portugal,2022,53,69508,77557,147065,89.6218
Portugal,2022,54,68717,78251,146968,87.8161
Portugal,2022,55,69526,79188,148714,87.7987
Portugal,2022,56,69992,79688,149680,87.8325
Portugal,2022,57,70193,80644,150837,87.0406
Portugal,2022,58,68288,78652,146940,86.823
Portugal,2022,59,67911,78311,146222,86.7196
Portugal,2022,60,67352,77838,145190,86.5284
Portugal,2022,61,67294,76722,144016,87.7115
Portugal,2022,62,63392,73489,136881,86.2605
Portugal,2022,63,62813,73480,136293,85.4831
Portugal,2022,64,61770,72214,133984,85.5374
Portugal,2022,65,59514,69933,129447,85.1015
Portugal,2022,66,59157,70774,129931,83.5858
Portugal,2022,67,57096,67895,124991,84.0946
Portugal,2022,68,54685,66400,121085,82.3569
Portugal,2022,69,55069,67587,122656,81.4787
Portugal,2022,70,55066,66094,121160,83.3147
Portugal,2022,71,53309,64610,117919,82.5089
Portugal,2022,72,51009,62177,113186,82.0384
Portugal,2022,73,50241,63970,114211,78.5384
Portugal,2022,74,43904,57090,100994,76.9031
Portugal,2022,75,42213,56424,98637,74.8139
Portugal,2022,76,42246,57800,100046,73.09
Portugal,2022,77,38125,53277,91402,71.56
Portugal,2022,78,35549,49885,85434,71.2619
Portugal,2022,79,31936,45889,77825,69.594
Portugal,2022,80,30273,43929,74202,68.9135
Portugal,2022,81,28975,43455,72430,66.6782
Portugal,2022,82,27111,42338,69449,64.0347
Portugal,2022,83,25597,40490,66087,63.2181
Portugal,2022,84,22206,37684,59890,58.9269
Portugal,2022,85,21553,37105,58658,58.0865
Portugal,2022,86,18773,34606,53379,54.2478
Portugal,2022,87,15698,29195,44893,53.7695
Portugal,2022,88,13243,26756,39999,49.4954
Portugal,2022,89,11291,23199,34490,48.6702
Portugal,2022,90,9786,19918,29704,49.1314
Portugal,2022,91,5633,13602,19235,41.413
Portugal,2022,92,4616,11304,15920,40.8351
Portugal,2022,93,3433,9347,12780,36.7284
Portugal,2022,94,2501,7142,9643,35.0182
Portugal,2022,95,1896,5853,7749,32.3936
Portugal,2022,96,1243,4276,5519,29.0692
Portugal,2022,97,880,3055,3935,28.8052
Portugal,2022,98,553,2085,2638,26.5228
Portugal,2022,99,347,1354,1701,25.6278
Portugal,2022,100,423,1985,2408,21.3098
Portugal,2023,0,41067,38962,80029,105.4027
Portugal,2023,1,41446,39384,80830,105.2356
Portugal,2023,2,43637,41396,85033,105.4136
Portugal,2023,3,44979,42667,87646,105.4187
Portugal,2023,4,44782,43461,88243,103.0395
Portugal,2023,5,44731,43117,87848,103.7433
Portugal,2023,6,45545,43396,88941,104.9521
Portugal,2023,7,44598,42978,87576,103.7694
Portugal,2023,8,43350,41019,84369,105.6827
Portugal,2023,9,43134,41560,84694,103.7873
Portugal,2023,10,46976,44471,91447,105.6329
Portugal,2023,11,49902,47484,97386,105.0922
Portugal,2023,12,51166,49979,101145,102.375
Portugal,2023,13,49649,47945,97594,103.5541
Portugal,2023,14,52067,49623,101690,104.9251
Portugal,2023,15,50994,48949,99943,104.1778
Portugal,2023,16,52242,50593,102835,103.2593
Portugal,2023,17,54862,52228,107090,105.0433
Portugal,2023,18,53820,51957,105777,103.5857
Portugal,2023,19,55395,53270,108665,103.9891
Portugal,2023,20,56129,53795,109924,104.3387
Portugal,2023,21,56060,53804,109864,104.193
Portugal,2023,22,60594,58532,119126,103.5229
Portugal,2023,23,58917,57596,116513,102.2936
Portugal,2023,24,57133,55768,112901,102.4476
Portugal,2023,25,56264,55698,111962,101.0162
Portugal,2023,26,56008,54288,110296,103.1683
Portugal,2023,27,54963,53713,108676,102.3272
Portugal,2023,28,54093,53605,107698,100.9104
Portugal,2023,29,55460,56086,111546,98.8839
Portugal,2023,30,55460,56564,112024,98.0482
Portugal,2023,31,56538,57145,113683,98.9378
Portugal,2023,32,56293,57251,113544,98.3267
Portugal,2023,33,55802,56732,112534,98.3607
Portugal,2023,34,56349,57741,114090,97.5892
Portugal,2023,35,56063,58069,114132,96.5455
Portugal,2023,36,56621,59359,115980,95.3874
Portugal,2023,37,58025,61097,119122,94.9719
Portugal,2023,38,61795,65771,127566,93.9548
Portugal,2023,39,63027,67483,130510,93.3969
Portugal,2023,40,65619,71275,136894,92.0645
Portugal,2023,41,65904,72305,138209,91.1472
Portugal,2023,42,69005,75636,144641,91.233
Portugal,2023,43,69029,75581,144610,91.3312
Portugal,2023,44,70740,78255,148995,90.3968
Portugal,2023,45,76934,84417,161351,91.1357
Portugal,2023,46,78265,86716,164981,90.2544
Portugal,2023,47,78661,86578,165239,90.8556
Portugal,2023,48,76665,85955,162620,89.192
Portugal,2023,49,74483,83379,157862,89.3306
Portugal,2023,50,74442,83693,158135,88.9465
Portugal,2023,51,73783,82704,156487,89.2133
Portugal,2023,52,71649,79815,151464,89.7688
Portugal,2023,53,69767,77885,147652,89.5769
Portugal,2023,54,69143,77402,146545,89.3297
Portugal,2023,55,68328,78084,146412,87.5058
Portugal,2023,56,69096,79002,148098,87.4611
Portugal,2023,57,69519,79484,149003,87.4629
Portugal,2023,58,69676,80424,150100,86.6358
Portugal,2023,59,67740,78417,146157,86.3843
Portugal,2023,60,67315,78048,145363,86.2482
Portugal,2023,61,66708,77550,144258,86.0193
Portugal,2023,62,66603,76418,143021,87.1562
Portugal,2023,63,62704,73179,135883,85.6858
Portugal,2023,64,62094,73144,135238,84.8928
Portugal,2023,65,61027,71855,132882,84.9308
Portugal,2023,66,58754,69555,128309,84.4713
Portugal,2023,67,58342,70357,128699,82.9228
Portugal,2023,68,56240,67453,123693,83.3766
Portugal,2023,69,53790,65911,119701,81.61
Portugal,2023,70,54090,67029,121119,80.6964
Portugal,2023,71,54003,65487,119490,82.4637
Portugal,2023,72,52186,63946,116132,81.6095
Portugal,2023,73,49831,61457,111288,81.0827
Portugal,2023,74,48962,63132,112094,77.555
Portugal,2023,75,42675,56246,98921,75.8721
Portugal,2023,76,40907,55477,96384,73.7369
Portugal,2023,77,40789,56686,97475,71.956
Portugal,2023,78,36655,52088,88743,70.3713
Portugal,2023,79,34015,48593,82608,69.9998
Portugal,2023,80,30390,44513,74903,68.2722
Portugal,2023,81,28612,42401,71013,67.4795
Portugal,2023,82,27167,41705,68872,65.1409
Portugal,2023,83,25197,40373,65570,62.4105
Portugal,2023,84,23554,38316,61870,61.473
Portugal,2023,85,20192,35310,55502,57.1849
Portugal,2023,86,19324,34339,53663,56.2742
Portugal,2023,87,16582,31597,48179,52.4797
Portugal,2023,88,13631,26282,39913,51.8644
Portugal,2023,89,11256,23697,34953,47.4997
Portugal,2023,90,9389,20176,29565,46.5355
Portugal,2023,91,7975,16993,24968,46.9311
Portugal,2023,92,4504,11395,15899,39.5261
Portugal,2023,93,3617,9305,12922,38.8716
Portugal,2023,94,2620,7527,10147,34.808
Portugal,2023,95,1848,5590,7438,33.059
Portugal,2023,96,1354,4438,5792,30.5092
Portugal,2023,97,860,3138,3998,27.406
Portugal,2023,98,589,2169,2758,27.1554
Portugal,2023,99,358,1430,1788,25.035
Portugal,2023,100,461,2106,2567,21.8898
Portugal,2024,0,40805,38664,79469,105.5375
Portugal,2024,1,41115,39014,80129,105.3852
Portugal,2024,2,41496,39436,80932,105.2237
Portugal,2024,3,43682,41441,85123,105.4077
Portugal,2024,4,45016,42706,87722,105.4091
Portugal,2024,5,44813,43494,88307,103.0326
Portugal,2024,6,44758,43145,87903,103.7386
Portugal,2024,7,45568,43420,88988,104.947
Portugal,2024,8,44618,42998,87616,103.7676
Portugal,2024,9,43367,41036,84403,105.6804
Portugal,2024,10,43148,41575,84723,103.7835
Portugal,2024,11,46989,44486,91475,105.6265
Portugal,2024,12,49919,47503,97422,105.086
Portugal,2024,13,51190,50006,101196,102.3677
Portugal,2024,14,49686,47987,97673,103.5405
Portugal,2024,15,52120,49685,101805,104.9009
Portugal,2024,16,51066,49034,100100,104.1441
Portugal,2024,17,52335,50703,103038,103.2187
Portugal,2024,18,54976,52363,107339,104.9902
Portugal,2024,19,53953,52114,106067,103.5288
Portugal,2024,20,55542,53443,108985,103.9275
Portugal,2024,21,56289,53981,110270,104.2756
Portugal,2024,22,56229,53999,110228,104.1297
Portugal,2024,23,60766,58729,119495,103.4685
Portugal,2024,24,59089,57792,116881,102.2443
Portugal,2024,25,57304,55962,113266,102.3981
Portugal,2024,26,56429,55887,112316,100.9698
Portugal,2024,27,56164,54467,110631,103.1156
Portugal,2024,28,55110,53882,108992,102.2791
Portugal,2024,29,54230,53762,107992,100.8705
Portugal,2024,30,55586,56229,111815,98.8565
Portugal,2024,31,55576,56696,112272,98.0246
Portugal,2024,32,56645,57265,113910,98.9173
Portugal,2024,33,56389,57360,113749,98.3072
Portugal,2024,34,55884,56829,112713,98.3371
Portugal,2024,35,56418,57827,114245,97.5634
Portugal,2024,36,56122,58145,114267,96.5208
Portugal,2024,37,56671,59424,116095,95.3672
Portugal,2024,38,58062,61150,119212,94.9501
Portugal,2024,39,61814,65810,127624,93.928
Portugal,2024,40,63028,67511,130539,93.3596
Portugal,2024,41,65599,71288,136887,92.0197
Portugal,2024,42,65868,72306,138174,91.0962
Portugal,2024,43,68947,75625,144572,91.1696
Portugal,2024,44,68952,75561,144513,91.2534
Portugal,2024,45,70640,78222,148862,90.3071
Portugal,2024,46,76797,84364,161161,91.0305
Portugal,2024,47,78096,86645,164741,90.1333
Portugal,2024,48,78463,86493,164956,90.716
Portugal,2024,49,76445,85856,162301,89.0386
Portugal,2024,50,74239,83271,157510,89.1535
Portugal,2024,51,74161,83571,157732,88.7401
Portugal,2024,52,73466,82568,156034,88.9764
Portugal,2024,53,71309,79668,150977,89.5077
Portugal,2024,54,69408,77731,147139,89.2926
Portugal,2024,55,68758,77239,145997,89.0198
Portugal,2024,56,67913,77903,145816,87.1764
Portugal,2024,57,68638,78803,147441,87.1007
Portugal,2024,58,69017,79270,148287,87.0657
Portugal,2024,59,69127,80187,149314,86.2072
Portugal,2024,60,67157,78158,145315,85.9247
Portugal,2024,61,66684,77764,144448,85.7518
Portugal,2024,62,66037,77248,143285,85.487
Portugal,2024,63,65894,76101,141995,86.5876
Portugal,2024,64,62001,72851,134852,85.1066
Portugal,2024,65,61363,72787,134150,84.3049
Portugal,2024,66,60266,71473,131739,84.32
Portugal,2024,67,57965,69153,127118,83.8214
Portugal,2024,68,57489,69907,127396,82.2364
Portugal,2024,69,55341,66965,122306,82.6417
Portugal,2024,70,52857,65376,118233,80.8508
Portugal,2024,71,53071,66424,119495,79.8973
Portugal,2024,72,52893,64827,117720,81.591
Portugal,2024,73,51010,63220,114230,80.6865
Portugal,2024,74,48594,60668,109262,80.0982
Portugal,2024,75,47626,62217,109843,76.5482
Portugal,2024,76,41389,55321,96710,74.8161
Portugal,2024,77,39531,54429,93960,72.6286
Portugal,2024,78,39254,55444,94698,70.7994
Portugal,2024,79,35110,50764,85874,69.1632
Portugal,2024,80,32405,47162,79567,68.71
Portugal,2024,81,28757,42990,71747,66.8923
Portugal,2024,82,26861,40719,67580,65.9667
Portugal,2024,83,25285,39798,65083,63.5333
Portugal,2024,84,23221,38236,61457,60.7307
Portugal,2024,85,21452,35935,57387,59.6967
Portugal,2024,86,18135,32710,50845,55.4418
Portugal,2024,87,17100,31387,48487,54.4812
Portugal,2024,88,14426,28477,42903,50.6584
Portugal,2024,89,11609,23304,34913,49.8155
Portugal,2024,90,9378,20634,30012,45.4493
Portugal,2024,91,7667,17234,24901,44.4876
Portugal,2024,92,6389,14254,20643,44.8225
Portugal,2024,93,3537,9393,12930,37.6557
Portugal,2024,94,2766,7503,10269,36.8653
Portugal,2024,95,1940,5900,7840,32.8814
Portugal,2024,96,1323,4244,5567,31.1734
Portugal,2024,97,939,3261,4200,28.7948
Portugal,2024,98,577,2231,2808,25.8628
Portugal,2024,99,381,1490,1871,25.5705
Portugal,2024,100,490,2232,2722,21.9534
Portugal,2025,0,40563,38396,78959,105.6438
Portugal,2025,1,40854,38717,79571,105.5195
Portugal,2025,2,41166,39066,80232,105.3755
Portugal,2025,3,41542,39482,81024,105.2176
Portugal,2025,4,43720,41480,85200,105.4002
Portugal,2025,5,45048,42739,87787,105.4026
Portugal,2025,6,44841,43522,88363,103.0307
Portugal,2025,7,44782,43169,87951,103.7365
Portugal,2025,8,45589,43439,89028,104.9495
Portugal,2025,9,44635,43015,87650,103.7661
Portugal,2025,10,43381,41051,84432,105.6759
Portugal,2025,11,43162,41591,84753,103.7773
Portugal,2025,12,47007,44505,91512,105.6218
Portugal,2025,13,49944,47531,97475,105.0767
Portugal,2025,14,51227,50048,101275,102.3557
Portugal,2025,15,49739,48048,97787,103.5194
Portugal,2025,16,52192,49770,101962,104.8664
Portugal,2025,17,51160,49145,100305,104.1001
Portugal,2025,18,52451,50838,103289,103.1728
Portugal,2025,19,55109,52519,107628,104.9315
Portugal,2025,20,54100,52287,106387,103.4674
Portugal,2025,21,55702,53630,109332,103.8635
Portugal,2025,22,56459,54176,110635,104.214
Portugal,2025,23,56403,54197,110600,104.0703
Portugal,2025,24,60938,58925,119863,103.4162
Portugal,2025,25,59259,57986,117245,102.1954
Portugal,2025,26,57469,56151,113620,102.3472
Portugal,2025,27,56586,56066,112652,100.9275
Portugal,2025,28,56311,54636,110947,103.0657
Portugal,2025,29,55248,54039,109287,102.2373
Portugal,2025,30,54358,53906,108264,100.8385
Portugal,2025,31,55703,56362,112065,98.8308
Portugal,2025,32,55684,56817,112501,98.0059
Portugal,2025,33,56742,57375,114117,98.8967
Portugal,2025,34,56471,57457,113928,98.2839
Portugal,2025,35,55954,56916,112870,98.3098
Portugal,2025,36,56479,57904,114383,97.539
Portugal,2025,37,56174,58211,114385,96.5007
Portugal,2025,38,56710,59479,116189,95.3446
Portugal,2025,39,58086,61193,119279,94.9226
Portugal,2025,40,61818,65839,127657,93.8927
Portugal,2025,41,63014,67528,130542,93.3154
Portugal,2025,42,65566,71291,136857,91.9695
Portugal,2025,43,65819,72298,138117,91.0385
Portugal,2025,44,68874,75607,144481,91.0947
Portugal,2025,45,68860,75532,144392,91.1667
Portugal,2025,46,70521,78177,148698,90.2068
Portugal,2025,47,76636,84298,160934,90.9108
Portugal,2025,48,77904,86561,164465,89.999
Portugal,2025,49,78242,86395,164637,90.5631
Portugal,2025,50,76199,85747,161946,88.8649
Portugal,2025,51,73964,83153,157117,88.9493
Portugal,2025,52,73849,83436,157285,88.5098
Portugal,2025,53,73123,82418,155541,88.7221
Portugal,2025,54,70948,79513,150461,89.2282
Portugal,2025,55,69029,77571,146600,88.9882
Portugal,2025,56,68349,77063,145412,88.6924
Portugal,2025,57,67472,77710,145182,86.8254
Portugal,2025,58,68153,78595,146748,86.7142
Portugal,2025,59,68485,79041,147526,86.6449
Portugal,2025,60,68544,79926,148470,85.7593
Portugal,2025,61,66540,77878,144418,85.4413
Portugal,2025,62,66026,77466,143492,85.2322
Portugal,2025,63,65349,76933,142282,84.9427
Portugal,2025,64,65173,75765,140938,86.0199
Portugal,2025,65,61289,72501,133790,84.5354
Portugal,2025,66,60616,72408,133024,83.7145
Portugal,2025,67,59476,71069,130545,83.6877
Portugal,2025,68,57139,68720,125859,83.1476
Portugal,2025,69,56593,69411,126004,81.5332
Portugal,2025,70,54405,66433,120838,81.8945
Portugal,2025,71,51888,64799,116687,80.0753
Portugal,2025,72,52009,65768,117777,79.0795
Portugal,2025,73,51733,64106,115839,80.6992
Portugal,2025,74,49778,62425,112203,79.7405
Portugal,2025,75,47304,59807,107111,79.0944
Portugal,2025,76,46228,61215,107443,75.5174
Portugal,2025,77,40034,54296,94330,73.7329
Portugal,2025,78,38083,53261,91344,71.5026
Portugal,2025,79,37642,54062,91704,69.6275
Portugal,2025,80,33488,49296,82784,67.9325
Portugal,2025,81,30701,45574,76275,67.3652
Portugal,2025,82,27033,41311,68344,65.4378
Portugal,2025,83,25037,38886,63923,64.3856
Portugal,2025,84,23340,37723,61063,61.8721
Portugal,2025,85,21187,35892,57079,59.0299
Portugal,2025,86,19303,33321,52624,57.9304
Portugal,2025,87,16078,29930,46008,53.7187
Portugal,2025,88,14907,28320,43227,52.6377
Portugal,2025,89,12311,25281,37592,48.6966
Portugal,2025,90,9693,20317,30010,47.7088
Portugal,2025,91,7675,17648,25323,43.4893
Portugal,2025,92,6156,14475,20631,42.5285
Portugal,2025,93,5029,11766,16795,42.7418
Portugal,2025,94,2711,7585,10296,35.7416
Portugal,2025,95,2053,5889,7942,34.8616
Portugal,2025,96,1392,4485,5877,31.0368
Portugal,2025,97,919,3123,4042,29.4268
Portugal,2025,98,631,2321,2952,27.1866
Portugal,2025,99,374,1534,1908,24.3807
Portugal,2025,100,524,2348,2872,22.3169
Portugal,2026,0,40299,38113,78412,105.7356
Portugal,2026,1,40613,38449,79062,105.6282
Portugal,2026,2,40905,38770,79675,105.5068
Portugal,2026,3,41212,39112,80324,105.3692
Portugal,2026,4,41580,39521,81101,105.2099
Portugal,2026,5,43752,41513,85265,105.3935
Portugal,2026,6,45076,42767,87843,105.399
Portugal,2026,7,44865,43546,88411,103.029
Portugal,2026,8,44803,43188,87991,103.7395
Portugal,2026,9,45605,43456,89061,104.9452
Portugal,2026,10,44649,43030,87679,103.7625
Portugal,2026,11,43395,41066,84461,105.6714
Portugal,2026,12,43180,41610,84790,103.7731
Portugal,2026,13,47032,44533,91565,105.6116
Portugal,2026,14,49981,47573,97554,105.0617
Portugal,2026,15,51280,50110,101390,102.3349
Portugal,2026,16,49812,48134,97946,103.4861
Portugal,2026,17,52286,49881,102167,104.8215
Portugal,2026,18,51276,49281,100557,104.0482
Portugal,2026,19,52585,50995,103580,103.118
Portugal,2026,20,55257,52693,107950,104.8659
Portugal,2026,21,54262,52474,106736,103.4074
Portugal,2026,22,55873,53825,109698,103.8049
Portugal,2026,23,56634,54374,111008,104.1564
Portugal,2026,24,56578,54394,110972,104.0151
Portugal,2026,25,61108,59119,120227,103.3644
Portugal,2026,26,59424,58175,117599,102.147
Portugal,2026,27,57626,56331,113957,102.2989
Portugal,2026,28,56733,56235,112968,100.8856
Portugal,2026,29,56449,54793,111242,103.0223
Portugal,2026,30,55376,54184,109560,102.1999
Portugal,2026,31,54477,54040,108517,100.8087
Portugal,2026,32,55812,56483,112295,98.812
Portugal,2026,33,55782,56927,112709,97.9887
Portugal,2026,34,56825,57472,114297,98.8742
Portugal,2026,35,56542,57544,114086,98.2587
Portugal,2026,36,56016,56993,113009,98.2858
Portugal,2026,37,56531,57971,114502,97.516
Portugal,2026,38,56215,58267,114482,96.4783
Portugal,2026,39,56736,59522,116258,95.3194
Portugal,2026,40,58095,61225,119320,94.8877
Portugal,2026,41,61807,65858,127665,93.8489
Portugal,2026,42,62987,67535,130522,93.2657
Portugal,2026,43,65519,71286,136805,91.9101
Portugal,2026,44,65754,72284,138038,90.9662
Portugal,2026,45,68785,75579,144364,91.0107
Portugal,2026,46,68748,75491,144239,91.0678
Portugal,2026,47,70380,78120,148500,90.0922
Portugal,2026,48,76452,84219,160671,90.7776
Portugal,2026,49,77689,86466,164155,89.8492
Portugal,2026,50,77995,86287,164282,90.3902
Portugal,2026,51,75922,85626,161548,88.667
Portugal,2026,52,73659,83020,156679,88.7244
Portugal,2026,53,73511,83286,156797,88.2633
Portugal,2026,54,72760,82259,155019,88.4523
Portugal,2026,55,70568,79350,149918,88.9326
Portugal,2026,56,68626,77397,146023,88.6675
Portugal,2026,57,67914,76876,144790,88.3423
Portugal,2026,58,67005,77508,144513,86.4491
Portugal,2026,59,67637,78370,146007,86.3047
Portugal,2026,60,67918,78788,146706,86.2035
Portugal,2026,61,67926,79644,147570,85.287
Portugal,2026,62,65896,77585,143481,84.9339
Portugal,2026,63,65353,77155,142508,84.7035
Portugal,2026,64,64648,76599,141247,84.398
Portugal,2026,65,64440,75408,139848,85.4551
Portugal,2026,66,60560,72131,132691,83.9584
Portugal,2026,67,59840,72005,131845,83.1053
Portugal,2026,68,58647,70631,129278,83.0329
Portugal,2026,69,56268,68241,124509,82.4548
Portugal,2026,70,55658,68870,124528,80.816
Portugal,2026,71,53431,65857,119288,81.1318
Portugal,2026,72,50873,64172,115045,79.276
Portugal,2026,73,50896,65052,115948,78.2389
Portugal,2026,74,50514,63316,113830,79.7808
Portugal,2026,75,48489,61558,110047,78.7696
Portugal,2026,76,45950,58864,104814,78.0613
Portugal,2026,77,44750,60104,104854,74.4543
Portugal,2026,78,38602,53155,91757,72.6216
Portugal,2026,79,36554,51959,88513,70.3516
Portugal,2026,80,35939,52528,88467,68.4187
Portugal,2026,81,31761,47664,79425,66.6352
Portugal,2026,82,28894,43823,72717,65.9334
Portugal,2026,83,25231,39480,64711,63.9083
Portugal,2026,84,23144,36888,60032,62.7413
Portugal,2026,85,21328,35442,56770,60.1772
Portugal,2026,86,19094,33315,52409,57.3135
Portugal,2026,87,17142,30521,47663,56.1646
Portugal,2026,88,14042,27036,41078,51.9382
Portugal,2026,89,12746,25171,37917,50.6376
Portugal,2026,90,10299,22068,32367,46.6694
Portugal,2026,91,7947,17399,25346,45.675
Portugal,2026,92,6174,14842,21016,41.5982
Portugal,2026,93,4855,11966,16821,40.5733
Portugal,2026,94,3864,9516,13380,40.6053
Portugal,2026,95,2016,5962,7978,33.8142
Portugal,2026,96,1476,4483,5959,32.9244
Portugal,2026,97,969,3305,4274,29.3192
Portugal,2026,98,619,2226,2845,27.8077
Portugal,2026,99,410,1598,2008,25.6571
Portugal,2026,100,537,2449,2986,21.9273
Portugal,2027,0,40291,38073,78364,105.8257
Portugal,2027,1,40350,38167,78517,105.7196
Portugal,2027,2,40665,38502,79167,105.6179
Portugal,2027,3,40951,38816,79767,105.5003
Portugal,2027,4,41250,39151,80401,105.3613
Portugal,2027,5,41613,39554,81167,105.2055
Portugal,2027,6,43780,41541,85321,105.3899
Portugal,2027,7,45100,42791,87891,105.396
Portugal,2027,8,44885,43566,88451,103.0276
Portugal,2027,9,44820,43205,88025,103.738
Portugal,2027,10,45620,43471,89091,104.9435
Portugal,2027,11,44663,43045,87708,103.7589
Portugal,2027,12,43413,41086,84499,105.6637
Portugal,2027,13,43205,41638,84843,103.7634
Portugal,2027,14,47069,44576,91645,105.5927
Portugal,2027,15,50034,47635,97669,105.0362
Portugal,2027,16,51353,50195,101548,102.307
Portugal,2027,17,49907,48245,98152,103.4449
Portugal,2027,18,52402,50017,102419,104.7684
Portugal,2027,19,51411,49438,100849,103.9909
Portugal,2027,20,52734,51169,103903,103.0585
Portugal,2027,21,55419,52880,108299,104.8014
Portugal,2027,22,54434,52670,107104,103.3492
Portugal,2027,23,56048,54023,110071,103.7484
Portugal,2027,24,56809,54572,111381,104.0992
Portugal,2027,25,56750,54589,111339,103.9587
Portugal,2027,26,61273,59308,120581,103.3132
Portugal,2027,27,59581,58354,117935,102.1027
Portugal,2027,28,57774,56500,114274,102.2549
Portugal,2027,29,56872,56392,113264,100.8512
Portugal,2027,30,56577,54938,111515,102.9834
Portugal,2027,31,55494,54317,109811,102.1669
Portugal,2027,32,54587,54162,108749,100.7847
Portugal,2027,33,55911,56593,112504,98.7949
Portugal,2027,34,55867,57025,112892,97.9693
Portugal,2027,35,56896,57559,114455,98.8481
Portugal,2027,36,56605,57622,114227,98.235
Portugal,2027,37,56070,57061,113131,98.2633
Portugal,2027,38,56573,58027,114600,97.4943
Portugal,2027,39,56243,58312,114555,96.4518
Portugal,2027,40,56749,59557,116306,95.2852
Portugal,2027,41,58091,61248,119339,94.8455
Portugal,2027,42,61783,65867,127650,93.7996
Portugal,2027,43,62946,67533,130479,93.2078
Portugal,2027,44,65457,71273,136730,91.8398
Portugal,2027,45,65673,72261,137934,90.883
Portugal,2027,46,68676,75539,144215,90.9146
Portugal,2027,47,68615,75439,144054,90.9543
Portugal,2027,48,70219,78052,148271,89.9644
Portugal,2027,49,76246,84129,160375,90.6299
Portugal,2027,50,77449,86360,163809,89.6816
Portugal,2027,51,77716,86168,163884,90.1913
Portugal,2027,52,75614,85491,161105,88.4467
Portugal,2027,53,73328,82874,156202,88.4813
Portugal,2027,54,73152,83128,156280,87.9992
Portugal,2027,55,72377,82093,154470,88.1646
Portugal,2027,56,70163,79175,149338,88.6176
Portugal,2027,57,68196,77211,145407,88.3242
Portugal,2027,58,67452,76679,144131,87.9667
Portugal,2027,59,66507,77291,143798,86.0475
Portugal,2027,60,67088,78124,145212,85.8737
Portugal,2027,61,67316,78514,145830,85.7376
Portugal,2027,62,67281,79348,146629,84.7923
Portugal,2027,63,65238,77279,142517,84.4188
Portugal,2027,64,64667,76827,141494,84.1722
Portugal,2027,65,63937,76245,140182,83.8573
Portugal,2027,66,63690,75030,138720,84.886
Portugal,2027,67,59801,71738,131539,83.3603
Portugal,2027,68,59025,71571,130596,82.4706
Portugal,2027,69,57773,70149,127922,82.3576
Portugal,2027,70,55360,67721,123081,81.7472
Portugal,2027,71,54685,68286,122971,80.0823
Portugal,2027,72,52411,65233,117644,80.3443
Portugal,2027,73,49811,63488,113299,78.4573
Portugal,2027,74,49726,64268,113994,77.3729
Portugal,2027,75,49238,62455,111693,78.8376
Portugal,2027,76,47135,60607,107742,77.7715
Portugal,2027,77,44516,57818,102334,76.9933
Portugal,2027,78,43187,58866,102053,73.3649
Portugal,2027,79,37087,51881,88968,71.4847
Portugal,2027,80,34937,50512,85449,69.1657
Portugal,2027,81,34123,50819,84942,67.1461
Portugal,2027,82,29927,45862,75789,65.2545
Portugal,2027,83,27002,41911,68913,64.427
Portugal,2027,84,23356,37482,60838,62.3126
Portugal,2027,85,21181,34689,55870,61.0597
Portugal,2027,86,19253,32930,52183,58.4664
Portugal,2027,87,16986,30548,47534,55.6043
Portugal,2027,88,14998,27602,42600,54.3366
Portugal,2027,89,12028,24059,36087,49.9938
Portugal,2027,90,10683,21999,32682,48.5613
Portugal,2027,91,8461,18922,27383,44.7151
Portugal,2027,92,6406,14651,21057,43.724
Portugal,2027,93,4880,12287,17167,39.7168
Portugal,2027,94,3738,9691,13429,38.5719
Portugal,2027,95,2879,7490,10369,38.4379
Portugal,2027,96,1452,4545,5997,31.9472
Portugal,2027,97,1029,3308,4337,31.1064
Portugal,2027,98,653,2358,3011,27.693
Portugal,2027,99,402,1534,1936,26.206
Portugal,2027,100,570,2551,3121,22.3442
Portugal,2028,0,40232,37996,78228,105.8848
Portugal,2028,1,40343,38128,78471,105.8094
Portugal,2028,2,40402,38220,78622,105.7091
Portugal,2028,3,40711,38549,79260,105.6084
Portugal,2028,4,40990,38855,79845,105.4948
Portugal,2028,5,41283,39185,80468,105.3541
Portugal,2028,6,41641,39583,81224,105.1992
Portugal,2028,7,43804,41565,85369,105.3867
Portugal,2028,8,45120,42811,87931,105.3935
Portugal,2028,9,44902,43583,88485,103.0264
Portugal,2028,10,44834,43221,88055,103.732
Portugal,2028,11,45634,43487,89121,104.9371
Portugal,2028,12,44681,43065,87746,103.7525
Portugal,2028,13,43438,41114,84552,105.6526
Portugal,2028,14,43243,41681,84924,103.7475
Portugal,2028,15,47123,44638,91761,105.567
Portugal,2028,16,50108,47721,97829,105.002
Portugal,2028,17,51448,50306,101754,102.2701
Portugal,2028,18,50024,48381,98405,103.396
Portugal,2028,19,52537,50174,102711,104.7096
Portugal,2028,20,51562,49612,101174,103.9305
Portugal,2028,21,52897,51357,104254,102.9986
Portugal,2028,22,55591,53076,108667,104.7385
Portugal,2028,23,54610,52868,107478,103.295
Portugal,2028,24,56224,54221,110445,103.6941
Portugal,2028,25,56982,54767,111749,104.0444
Portugal,2028,26,56917,54778,111695,103.9049
Portugal,2028,27,61430,59488,120918,103.2645
Portugal,2028,28,59729,58523,118252,102.0607
Portugal,2028,29,57912,56657,114569,102.2151
Portugal,2028,30,57000,56537,113537,100.8189
Portugal,2028,31,56696,55072,111768,102.9489
Portugal,2028,32,55605,54440,110045,102.14
Portugal,2028,33,54687,54273,108960,100.7628
Portugal,2028,34,55996,56692,112688,98.7723
Portugal,2028,35,55940,57113,113053,97.9462
Portugal,2028,36,56960,57638,114598,98.8237
Portugal,2028,37,56659,57690,114349,98.2129
Portugal,2028,38,56113,57118,113231,98.2405
Portugal,2028,39,56602,58073,114675,97.467
Portugal,2028,40,56257,58348,114605,96.4163
Portugal,2028,41,56748,59582,116330,95.2435
Portugal,2028,42,58074,61261,119335,94.7977
Portugal,2028,43,61746,65868,127614,93.742
Portugal,2028,44,62891,67525,130416,93.1374
Portugal,2028,45,65380,71252,136632,91.7588
Portugal,2028,46,65574,72226,137800,90.79
Portugal,2028,47,68546,75488,144034,90.8038
Portugal,2028,48,68461,75375,143836,90.8272
Portugal,2028,49,70036,77972,148008,89.822
Portugal,2028,50,76016,84028,160044,90.4651
Portugal,2028,51,77177,86242,163419,89.4889
Portugal,2028,52,77405,86034,163439,89.9702
Portugal,2028,53,75279,85342,160621,88.2086
Portugal,2028,54,72976,82719,155695,88.2216
Portugal,2028,55,72773,82963,155736,87.7174
Portugal,2028,56,71968,81914,153882,87.858
Portugal,2028,57,69731,78988,148719,88.2805
Portugal,2028,58,67741,77017,144758,87.9559
Portugal,2028,59,66959,76468,143427,87.5647
Portugal,2028,60,65976,77052,143028,85.6253
Portugal,2028,61,66504,77857,144361,85.4181
Portugal,2028,62,66688,78228,144916,85.2482
Portugal,2028,63,66621,79041,145662,84.2866
Portugal,2028,64,64566,76956,141522,83.8999
Portugal,2028,65,63970,76478,140448,83.645
Portugal,2028,66,63209,75870,139079,83.3122
Portugal,2028,67,62908,74629,137537,84.2943
Portugal,2028,68,59005,71314,130319,82.7397
Portugal,2028,69,58165,71092,129257,81.8165
Portugal,2028,70,56862,69625,126487,81.6689
Portugal,2028,71,54414,67158,121572,81.0239
Portugal,2028,72,53664,67651,121315,79.3248
Portugal,2028,73,51342,64552,115894,79.5359
Portugal,2028,74,48692,62739,111431,77.6104
Portugal,2028,75,48499,63412,111911,76.4824
Portugal,2028,76,47894,61512,109406,77.8612
Portugal,2028,77,45697,59553,105250,76.7333
Portugal,2028,78,42996,56652,99648,75.8949
Portugal,2028,79,41529,57483,99012,72.2457
Portugal,2028,80,35479,50463,85942,70.307
Portugal,2028,81,33204,48896,82100,67.9074
Portugal,2028,82,32186,48928,81114,65.7824
Portugal,2028,83,28001,43893,71894,63.7938
Portugal,2028,84,25028,39821,64849,62.8513
Portugal,2028,85,21405,35280,56685,60.6718
Portugal,2028,86,19149,32262,51411,59.3547
Portugal,2028,87,17153,30226,47379,56.7492
Portugal,2028,88,14886,27658,42544,53.8217
Portugal,2028,89,12869,24592,37461,52.33
Portugal,2028,90,10099,21053,31152,47.9694
Portugal,2028,91,8791,18887,27678,46.5452
Portugal,2028,92,6831,15954,22785,42.8168
Portugal,2028,93,5073,12147,17220,41.7634
Portugal,2028,94,3764,9965,13729,37.7722
Portugal,2028,95,2791,7639,10430,36.5362
Portugal,2028,96,2078,5718,7796,36.3414
Portugal,2028,97,1015,3358,4373,30.2263
Portugal,2028,98,695,2363,3058,29.4118
Portugal,2028,99,426,1627,2053,26.1832
Portugal,2028,100,583,2577,3160,22.6232
Portugal,2029,0,40261,37999,78260,105.9528
Portugal,2029,1,40284,38051,78335,105.8684
Portugal,2029,2,40395,38182,78577,105.7959
Portugal,2029,3,40448,38267,78715,105.6994
Portugal,2029,4,40750,38588,79338,105.6028
Portugal,2029,5,41023,38889,79912,105.4874
Portugal,2029,6,41311,39214,80525,105.3476
Portugal,2029,7,41665,39607,81272,105.1961
Portugal,2029,8,43824,41586,85410,105.3816
Portugal,2029,9,45138,42828,87966,105.3937
Portugal,2029,10,44917,43598,88515,103.0254
Portugal,2029,11,44848,43236,88084,103.7284
Portugal,2029,12,45652,43506,89158,104.9327
Portugal,2029,13,44707,43093,87800,103.7454
Portugal,2029,14,43476,41156,84632,105.6371
Portugal,2029,15,43297,41743,85040,103.7228
Portugal,2029,16,47197,44724,91921,105.5295
Portugal,2029,17,50203,47832,98035,104.9569
Portugal,2029,18,51565,50442,102007,102.2263
Portugal,2029,19,50160,48538,98698,103.3417
Portugal,2029,20,52688,50349,103037,104.6456
Portugal,2029,21,51726,49801,101527,103.8654
Portugal,2029,22,53071,51553,104624,102.9445
Portugal,2029,23,55767,53275,109042,104.6776
Portugal,2029,24,54787,53067,107854,103.2412
Portugal,2029,25,56398,54417,110815,103.6404
Portugal,2029,26,57149,54956,112105,103.9905
Portugal,2029,27,57077,54959,112036,103.8538
Portugal,2029,28,61578,59657,121235,103.2201
Portugal,2029,29,59867,58680,118547,102.0228
Portugal,2029,30,58041,56802,114843,102.1813
Portugal,2029,31,57120,56671,113791,100.7923
Portugal,2029,32,56806,55195,112001,102.9187
Portugal,2029,33,55705,54551,110256,102.1155
Portugal,2029,34,54774,54373,109147,100.7375
Portugal,2029,35,56070,56780,112850,98.7496
Portugal,2029,36,56005,57192,113197,97.9245
Portugal,2029,37,57015,57706,114721,98.8026
Portugal,2029,38,56703,57747,114450,98.1921
Portugal,2029,39,56143,57165,113308,98.2122
Portugal,2029,40,56617,58110,114727,97.4307
Portugal,2029,41,56258,58374,114632,96.3751
Portugal,2029,42,56734,59597,116331,95.1961
Portugal,2029,43,58044,61267,119311,94.7394
Portugal,2029,44,61695,65862,127557,93.6731
Portugal,2029,45,62820,67508,130328,93.0556
Portugal,2029,46,65284,71219,136503,91.6665
Portugal,2029,47,65455,72180,137635,90.683
Portugal,2029,48,68396,75426,143822,90.6796
Portugal,2029,49,68288,75301,143589,90.6867
Portugal,2029,50,69831,77882,147713,89.6626
Portugal,2029,51,75754,83917,159671,90.2725
Portugal,2029,52,76874,86111,162985,89.2731
Portugal,2029,53,77067,85887,162954,89.7307
Portugal,2029,54,74924,85186,160110,87.9534
Portugal,2029,55,72605,82558,155163,87.9442
Portugal,2029,56,72369,82785,155154,87.418
Portugal,2029,57,71532,81724,153256,87.5288
Portugal,2029,58,69272,78793,148065,87.9164
Portugal,2029,59,67254,76809,144063,87.5601
Portugal,2029,60,66433,76236,142669,87.1412
Portugal,2029,61,65411,76793,142204,85.1783
Portugal,2029,62,65894,77578,143472,84.939
Portugal,2029,63,66046,77930,143976,84.7504
Portugal,2029,64,65948,78716,144664,83.7797
Portugal,2029,65,63884,76613,140497,83.3853
Portugal,2029,66,63255,76109,139364,83.1111
Portugal,2029,67,62449,75473,137922,82.7435
Portugal,2029,68,62088,74197,136285,83.6799
Portugal,2029,69,58162,70846,129008,82.0964
Portugal,2029,70,57266,70572,127838,81.1455
Portugal,2029,71,55910,69058,124968,80.9609
Portugal,2029,72,53419,66547,119966,80.2726
Portugal,2029,73,52593,66961,119554,78.5427
Portugal,2029,74,50213,63807,114020,78.6951
Portugal,2029,75,47517,61922,109439,76.7369
Portugal,2029,76,47204,62475,109679,75.5566
Portugal,2029,77,46464,60464,106928,76.8457
Portugal,2029,78,44169,58377,102546,75.6616
Portugal,2029,79,41378,55348,96726,74.7597
Portugal,2029,80,39762,55942,95704,71.0772
Portugal,2029,81,33750,48878,82628,69.0495
Portugal,2029,82,31350,47107,78457,66.5506
Portugal,2029,83,30147,46860,77007,64.3342
Portugal,2029,84,25984,41737,67721,62.2565
Portugal,2029,85,22968,37515,60483,61.2235
Portugal,2029,86,19378,32843,52221,59.0019
Portugal,2029,87,17085,29644,46729,57.6339
Portugal,2029,88,15056,27398,42454,54.9529
Portugal,2029,89,12793,24670,37463,51.8565
Portugal,2029,90,10823,21546,32369,50.2321
Portugal,2029,91,8325,18098,26423,45.9996
Portugal,2029,92,7110,15946,23056,44.588
Portugal,2029,93,5420,13246,18666,40.918
Portugal,2029,94,3920,9866,13786,39.7324
Portugal,2029,95,2816,7867,10683,35.7951
Portugal,2029,96,2018,5840,7858,34.5548
Portugal,2029,97,1454,4230,5684,34.3735
Portugal,2029,98,686,2402,3088,28.5595
Portugal,2029,99,454,1632,2086,27.8186
Portugal,2029,100,605,2652,3257,22.813
Portugal,2030,0,40219,37938,78157,106.0124
Portugal,2030,1,40314,38055,78369,105.9361
Portugal,2030,2,40337,38105,78442,105.8575
Portugal,2030,3,40441,38228,78669,105.789
Portugal,2030,4,40487,38306,78793,105.6936
Portugal,2030,5,40783,38622,79405,105.5953
Portugal,2030,6,41051,38918,79969,105.4808
Portugal,2030,7,41336,39238,80574,105.3469
Portugal,2030,8,41686,39627,81313,105.196
Portugal,2030,9,43842,41603,85445,105.3818
Portugal,2030,10,45152,42843,87995,105.3894
Portugal,2030,11,44931,43614,88545,103.0197
Portugal,2030,12,44866,43256,88122,103.722
Portugal,2030,13,45677,43534,89211,104.9226
Portugal,2030,14,44744,43136,87880,103.7277
Portugal,2030,15,43531,41219,84750,105.6091
Portugal,2030,16,43372,41830,85202,103.6863
Portugal,2030,17,47293,44836,92129,105.48
Portugal,2030,18,50320,47968,98288,104.9033
Portugal,2030,19,51701,50600,102301,102.1759
Portugal,2030,20,50311,48713,99024,103.2804
Portugal,2030,21,52852,50537,103389,104.5808
Portugal,2030,22,51900,49997,101897,103.8062
Portugal,2030,23,53248,51752,105000,102.8907
Portugal,2030,24,55944,53473,109417,104.621
Portugal,2030,25,54962,53262,108224,103.1918
Portugal,2030,26,56566,54606,111172,103.5893
Portugal,2030,27,57309,55137,112446,103.9393
Portugal,2030,28,57227,55129,112356,103.8056
Portugal,2030,29,61716,59814,121530,103.1799
Portugal,2030,30,59996,58825,118821,101.9907
Portugal,2030,31,58160,56936,115096,102.1498
Portugal,2030,32,57230,56793,114023,100.7695
Portugal,2030,33,56907,55306,112213,102.8948
Portugal,2030,34,55792,54651,110443,102.0878
Portugal,2030,35,54849,54462,109311,100.7106
Portugal,2030,36,56135,56860,112995,98.7249
Portugal,2030,37,56061,57261,113322,97.9043
Portugal,2030,38,57059,57764,114823,98.7795
Portugal,2030,39,56733,57794,114527,98.1642
Portugal,2030,40,56160,57203,113363,98.1767
Portugal,2030,41,56618,58136,114754,97.3889
Portugal,2030,42,56246,58390,114636,96.3281
Portugal,2030,43,56708,59604,116312,95.1413
Portugal,2030,44,58001,61265,119266,94.6723
Portugal,2030,45,61628,65848,127476,93.5913
Portugal,2030,46,62732,67481,130213,92.9625
Portugal,2030,47,65167,71176,136343,91.5575
Portugal,2030,48,65316,72123,137439,90.562
Portugal,2030,49,68226,75353,143579,90.5418
Portugal,2030,50,68092,75217,143309,90.5274
Portugal,2030,51,69597,77783,147380,89.4758
Portugal,2030,52,75462,83792,159254,90.0587
Portugal,2030,53,76544,85966,162510,89.0399
Portugal,2030,54,76708,85731,162439,89.4752
Portugal,2030,55,74547,85021,159568,87.6807
Portugal,2030,56,72207,82384,154591,87.6469
Portugal,2030,57,71936,82595,154531,87.0949
Portugal,2030,58,71068,81524,152592,87.1743
Portugal,2030,59,68782,78582,147364,87.529
Portugal,2030,60,66734,76578,143312,87.1451
Portugal,2030,61,65873,75983,141856,86.6944
Portugal,2030,62,64821,76522,141343,84.709
Portugal,2030,63,65270,77287,142557,84.4515
Portugal,2030,64,65390,77615,143005,84.2492
Portugal,2030,65,65263,78371,143634,83.2744
Portugal,2030,66,63183,76249,139432,82.864
Portugal,2030,67,62509,75717,138226,82.5561
Portugal,2030,68,61650,75043,136693,82.1529
Portugal,2030,69,61217,73718,134935,83.0421
Portugal,2030,70,57281,70337,127618,81.4379
Portugal,2030,71,56326,70007,126333,80.4577
Portugal,2030,72,54908,68441,123349,80.2268
Portugal,2030,73,52374,65880,118254,79.4991
Portugal,2030,74,51460,66201,117661,77.733
Portugal,2030,75,49026,62991,112017,77.8302
Portugal,2030,76,46275,61023,107298,75.8321
Portugal,2030,77,45823,61430,107253,74.5938
Portugal,2030,78,44941,59291,104232,75.7973
Portugal,2030,79,42538,57056,99594,74.5548
Portugal,2030,80,39650,53888,93538,73.5785
Portugal,2030,81,37856,54210,92066,69.8321
Portugal,2030,82,31895,47114,79009,67.6975
Portugal,2030,83,29394,45144,74538,65.1116
Portugal,2030,84,28007,44589,72596,62.8115
Portugal,2030,85,23874,39349,63223,60.6724
Portugal,2030,86,20819,34952,55771,59.5645
Portugal,2030,87,17312,30205,47517,57.315
Portugal,2030,88,15018,26897,41915,55.8352
Portugal,2030,89,12958,24463,37421,52.9698
Portugal,2030,90,10776,21637,32413,49.8036
Portugal,2030,91,8935,18541,27476,48.1905
Portugal,2030,92,6743,15296,22039,44.0834
Portugal,2030,93,5650,13255,18905,42.6254
Portugal,2030,94,4196,10772,14968,38.9528
Portugal,2030,95,2938,7798,10736,37.6763
Portugal,2030,96,2039,6021,8060,33.8648
Portugal,2030,97,1414,4325,5739,32.6936
Portugal,2030,98,985,3029,4014,32.519
Portugal,2030,99,448,1661,2109,26.9717
Portugal,2030,100,637,2703,3340,23.5664
Portugal,2031,0,40267,37973,78240,106.0411
Portugal,2031,1,40272,37994,78266,105.9957
Portugal,2031,2,40367,38109,78476,105.9251
Portugal,2031,3,40383,38151,78534,105.8504
Portugal,2031,4,40480,38268,78748,105.7803
Portugal,2031,5,40520,38340,78860,105.686
Portugal,2031,6,40811,38650,79461,105.5912
Portugal,2031,7,41075,38942,80017,105.4774
Portugal,2031,8,41356,39258,80614,105.3441
Portugal,2031,9,41703,39645,81348,105.1911
Portugal,2031,10,43856,41618,85474,105.3775
Portugal,2031,11,45167,42859,88026,105.3851
Portugal,2031,12,44949,43633,88582,103.0161
Portugal,2031,13,44892,43284,88176,103.715
Portugal,2031,14,45715,43577,89292,104.9063
Portugal,2031,15,44799,43198,87997,103.7062
Portugal,2031,16,43605,41306,84911,105.5658
Portugal,2031,17,43469,41942,85411,103.6407
Portugal,2031,18,47411,44972,92383,105.4234
Portugal,2031,19,50457,48126,98583,104.8435
Portugal,2031,20,51852,50775,102627,102.1211
Portugal,2031,21,50476,48902,99378,103.2187
Portugal,2031,22,53026,50733,103759,104.5197
Portugal,2031,23,52078,50197,102275,103.7472
Portugal,2031,24,53426,51951,105377,102.8392
Portugal,2031,25,56119,53669,109788,104.565
Portugal,2031,26,55131,53452,108583,103.1411
Portugal,2031,27,56727,54787,111514,103.541
Portugal,2031,28,57460,55307,112767,103.8928
Portugal,2031,29,57367,55287,112654,103.7622
Portugal,2031,30,61844,59959,121803,103.1438
Portugal,2031,31,60115,58959,119074,101.9607
Portugal,2031,32,58271,57059,115330,102.1241
Portugal,2031,33,57331,56905,114236,100.7486
Portugal,2031,34,56994,55406,112400,102.8661
Portugal,2031,35,55867,54741,110608,102.057
Portugal,2031,36,54916,54543,109459,100.6839
Portugal,2031,37,56193,56929,113122,98.7072
Portugal,2031,38,56107,57319,113426,97.8855
Portugal,2031,39,57090,57812,114902,98.7511
Portugal,2031,40,56750,57832,114582,98.1291
Portugal,2031,41,56163,57231,113394,98.1339
Portugal,2031,42,56607,58154,114761,97.3398
Portugal,2031,43,56222,58400,114622,96.2705
Portugal,2031,44,56668,59605,116273,95.0726
Portugal,2031,45,57943,61256,119199,94.5916
Portugal,2031,46,61545,65823,127368,93.5008
Portugal,2031,47,62624,67442,130066,92.8561
Portugal,2031,48,65032,71122,136154,91.4372
Portugal,2031,49,65158,72056,137214,90.4269
Portugal,2031,50,68034,75271,143305,90.3854
Portugal,2031,51,67869,75124,142993,90.3426
Portugal,2031,52,69335,77671,147006,89.2676
Portugal,2031,53,75144,83653,158797,89.8282
Portugal,2031,54,76193,85813,162006,88.7896
Portugal,2031,55,76329,85569,161898,89.2017
Portugal,2031,56,74146,84844,158990,87.391
Portugal,2031,57,71783,82198,153981,87.3294
Portugal,2031,58,71477,82396,153873,86.7481
Portugal,2031,59,70572,81309,151881,86.7948
Portugal,2031,60,68258,78350,146608,87.1193
Portugal,2031,61,66180,76329,142509,86.7036
Portugal,2031,62,65289,75719,141008,86.2254
Portugal,2031,63,64219,76240,140459,84.2327
Portugal,2031,64,64634,76981,141615,83.961
Portugal,2031,65,64724,77281,142005,83.7515
Portugal,2031,66,64561,78007,142568,82.7631
Portugal,2031,67,62453,75865,138318,82.3212
Portugal,2031,68,61725,75295,137020,81.9776
Portugal,2031,69,60803,74569,135372,81.5392
Portugal,2031,70,60309,73199,133508,82.3905
Portugal,2031,71,56361,69786,126147,80.7626
Portugal,2031,72,55338,69395,124733,79.7435
Portugal,2031,73,53857,67770,121627,79.4703
Portugal,2031,74,51271,65149,116420,78.6981
Portugal,2031,75,50270,65374,115644,76.896
Portugal,2031,76,47772,62097,109869,76.9313
Portugal,2031,77,44950,60024,104974,74.8867
Portugal,2031,78,44353,60263,104616,73.5991
Portugal,2031,79,43316,57977,101293,74.7124
Portugal,2031,80,40796,55580,96376,73.4005
Portugal,2031,81,37782,52249,90031,72.3114
Portugal,2031,82,35809,52286,88095,68.4868
Portugal,2031,83,29937,45182,75119,66.2587
Portugal,2031,84,27340,42989,70329,63.5977
Portugal,2031,85,25765,42075,67840,61.2359
Portugal,2031,86,21669,36697,58366,59.0484
Portugal,2031,87,18626,32178,50804,57.8843
Portugal,2031,88,15241,27436,42677,55.5511
Portugal,2031,89,12946,24044,36990,53.843
Portugal,2031,90,10933,21482,32415,50.8938
Portugal,2031,91,8911,18644,27555,47.7955
Portugal,2031,92,7250,15692,22942,46.2019
Portugal,2031,93,5369,12733,18102,42.166
Portugal,2031,94,4382,10795,15177,40.5929
Portugal,2031,95,3150,8526,11676,36.9458
Portugal,2031,96,2130,5976,8106,35.6426
Portugal,2031,97,1431,4465,5896,32.0493
Portugal,2031,98,959,3101,4060,30.9255
Portugal,2031,99,644,2097,2741,30.7105
Portugal,2031,100,654,2756,3410,23.73
Portugal,2032,0,40324,38006,78330,106.099
Portugal,2032,1,40321,38030,78351,106.0242
Portugal,2032,2,40325,38048,78373,105.9845
Portugal,2032,3,40413,38155,78568,105.918
Portugal,2032,4,40422,38191,78613,105.8417
Portugal,2032,5,40513,38301,78814,105.7753
Portugal,2032,6,40548,38369,78917,105.6791
Portugal,2032,7,40835,38675,79510,105.585
Portugal,2032,8,41096,38962,80058,105.4771
Portugal,2032,9,41374,39276,80650,105.3417
Portugal,2032,10,41718,39660,81378,105.1891
Portugal,2032,11,43871,41634,85505,105.373
Portugal,2032,12,45185,42879,88064,105.3779
Portugal,2032,13,44975,43662,88637,103.0072
Portugal,2032,14,44930,43327,88257,103.6998
Portugal,2032,15,45769,43640,89409,104.8786
Portugal,2032,16,44874,43285,88159,103.671
Portugal,2032,17,43702,41418,85120,105.5145
Portugal,2032,18,43588,42079,85667,103.5861
Portugal,2032,19,47549,45131,92680,105.3577
Portugal,2032,20,50609,48301,98910,104.7784
Portugal,2032,21,52017,50963,102980,102.0682
Portugal,2032,22,50651,49099,99750,103.161
Portugal,2032,23,53204,50933,104137,104.4588
Portugal,2032,24,52257,50396,102653,103.6928
Portugal,2032,25,53602,52147,105749,102.7902
Portugal,2032,26,56288,53859,110147,104.5099
Portugal,2032,27,55293,53634,108927,103.0932
Portugal,2032,28,56878,54958,111836,103.4936
Portugal,2032,29,57601,55465,113066,103.8511
Portugal,2032,30,57498,55433,112931,103.7252
Portugal,2032,31,61963,60092,122055,103.1136
Portugal,2032,32,60226,59082,119308,101.9363
Portugal,2032,33,58372,57170,115542,102.1025
Portugal,2032,34,57419,57005,114424,100.7263
Portugal,2032,35,57069,55496,112565,102.8344
Portugal,2032,36,55934,54821,110755,102.0302
Portugal,2032,37,54975,54613,109588,100.6628
Portugal,2032,38,56239,56988,113227,98.6857
Portugal,2032,39,56140,57368,113508,97.8594
Portugal,2032,40,57108,57850,114958,98.7174
Portugal,2032,41,56754,57861,114615,98.0868
Portugal,2032,42,56154,57249,113403,98.0873
Portugal,2032,43,56584,58164,114748,97.2835
Portugal,2032,44,56185,58402,114587,96.2039
Portugal,2032,45,56615,59598,116213,94.9948
Portugal,2032,46,57869,61236,119105,94.5016
Portugal,2032,47,61442,65788,127230,93.3939
Portugal,2032,48,62498,67394,129892,92.7353
Portugal,2032,49,64878,71058,135936,91.3029
Portugal,2032,50,64979,71981,136960,90.2724
Portugal,2032,51,67814,75179,142993,90.2034
Portugal,2032,52,67618,75018,142636,90.1357
Portugal,2032,53,69049,77546,146595,89.0426
Portugal,2032,54,74805,83507,158312,89.5793
Portugal,2032,55,75822,85653,161475,88.5223
Portugal,2032,56,75923,85393,161316,88.9101
Portugal,2032,57,73716,84656,158372,87.0771
Portugal,2032,58,71332,82004,153336,86.986
Portugal,2032,59,70987,82183,153170,86.3767
Portugal,2032,60,70043,81073,151116,86.395
Portugal,2032,61,67700,78099,145799,86.6848
Portugal,2032,62,65602,76068,141670,86.2413
Portugal,2032,63,64692,75446,140138,85.7461
Portugal,2032,64,63604,75944,139548,83.7512
Portugal,2032,65,63988,76656,140644,83.4742
Portugal,2032,66,64041,76929,140970,83.2469
Portugal,2032,67,63829,77621,141450,82.2316
Portugal,2032,68,61685,75450,137135,81.7561
Portugal,2032,69,60894,74829,135723,81.3775
Portugal,2032,70,59919,74054,133973,80.9126
Portugal,2032,71,59358,72638,131996,81.7176
Portugal,2032,72,55392,69189,124581,80.059
Portugal,2032,73,54301,68729,123030,79.0074
Portugal,2032,74,52745,67034,119779,78.684
Portugal,2032,75,50110,64353,114463,77.8674
Portugal,2032,76,49010,64466,113476,76.0246
Portugal,2032,77,46431,61103,107534,75.9881
Portugal,2032,78,43536,58909,102445,73.9038
Portugal,2032,79,42780,58955,101735,72.5638
Portugal,2032,80,41574,56506,98080,73.5745
Portugal,2032,81,38906,53920,92826,72.155
Portugal,2032,82,35771,50426,86197,70.9376
Portugal,2032,83,33644,50177,83821,67.0506
Portugal,2032,84,27875,43060,70935,64.7353
Portugal,2032,85,25181,40601,65782,62.0206
Portugal,2032,86,23415,39276,62691,59.6166
Portugal,2032,87,19412,33819,53231,57.3997
Portugal,2032,88,16420,29262,45682,56.1137
Portugal,2032,89,13157,24555,37712,53.5818
Portugal,2032,90,10939,21140,32079,51.7455
Portugal,2032,91,9054,18534,27588,48.8508
Portugal,2032,92,7241,15799,23040,45.832
Portugal,2032,93,5781,13081,18862,44.1939
Portugal,2032,94,4171,10386,14557,40.1598
Portugal,2032,95,3295,8557,11852,38.5065
Portugal,2032,96,2288,6544,8832,34.9633
Portugal,2032,97,1497,4438,5935,33.7314
Portugal,2032,98,972,3206,4178,30.3182
Portugal,2032,99,628,2150,2778,29.2093
Portugal,2032,100,786,3083,3869,25.4946
Portugal,2033,0,40181,37861,78042,106.1277
Portugal,2033,1,40379,38063,78442,106.0846
Portugal,2033,2,40374,38084,78458,106.013
Portugal,2033,3,40372,38095,78467,105.9772
Portugal,2033,4,40452,38195,78647,105.9092
Portugal,2033,5,40456,38225,78681,105.8365
Portugal,2033,6,40542,38330,78872,105.7709
Portugal,2033,7,40573,38393,78966,105.6781
Portugal,2033,8,40856,38695,79551,105.5847
Portugal,2033,9,41114,38980,80094,105.4746
Portugal,2033,10,41389,39291,80680,105.3396
Portugal,2033,11,41733,39676,81409,105.1845
Portugal,2033,12,43889,41654,85543,105.3656
Portugal,2033,13,45210,42907,88117,105.3674
Portugal,2033,14,45013,43704,88717,102.9951
Portugal,2033,15,44984,43389,88373,103.676
Portugal,2033,16,45844,43726,89570,104.8438
Portugal,2033,17,44971,43397,88368,103.627
Portugal,2033,18,43822,41555,85377,105.4554
Portugal,2033,19,43727,42237,85964,103.5277
Portugal,2033,20,47702,45306,93008,105.2885
Portugal,2033,21,50775,48490,99265,104.7123
Portugal,2033,22,52192,51160,103352,102.0172
Portugal,2033,23,50831,49299,100130,103.1076
Portugal,2033,24,53383,51132,104515,104.4023
Portugal,2033,25,52434,50592,103026,103.6409
Portugal,2033,26,53773,52338,106111,102.7418
Portugal,2033,27,56450,54040,110490,104.4597
Portugal,2033,28,55445,53804,109249,103.05
Portugal,2033,29,57020,55116,112136,103.4545
Portugal,2033,30,57732,55612,113344,103.8121
Portugal,2033,31,57619,55568,113187,103.691
Portugal,2033,32,62073,60215,122288,103.0856
Portugal,2033,33,60326,59193,119519,101.9141
Portugal,2033,34,58460,57270,115730,102.0779
Portugal,2033,35,57494,57094,114588,100.7006
Portugal,2033,36,57136,55577,112713,102.8051
Portugal,2033,37,55993,54893,110886,102.0039
Portugal,2033,38,55023,54674,109697,100.6383
Portugal,2033,39,56273,57038,113311,98.6588
Portugal,2033,40,56160,57407,113567,97.8278
Portugal,2033,41,57113,57879,114992,98.6765
Portugal,2033,42,56746,57879,114625,98.0425
Portugal,2033,43,56133,57261,113394,98.0301
Portugal,2033,44,56548,58167,114715,97.2166
Portugal,2033,45,56134,58397,114531,96.1248
Portugal,2033,46,56546,59581,116127,94.9061
Portugal,2033,47,57777,61207,118984,94.3961
Portugal,2033,48,61322,65743,127065,93.2753
Portugal,2033,49,62354,67336,129690,92.6013
Portugal,2033,50,64703,70985,135688,91.1502
Portugal,2033,51,64774,71895,136669,90.0953
Portugal,2033,52,67568,75075,142643,90.0007
Portugal,2033,53,67344,74900,142244,89.9119
Portugal,2033,54,68745,77414,146159,88.8018
Portugal,2033,55,74447,83355,157802,89.3132
Portugal,2033,56,75426,85480,160906,88.2382
Portugal,2033,57,75490,85206,160696,88.597
Portugal,2033,58,73260,84458,157718,86.7413
Portugal,2033,59,70850,81794,152644,86.62
Portugal,2033,60,70462,81947,152409,85.9848
Portugal,2033,61,69479,80816,150295,85.9718
Portugal,2033,62,67118,77836,144954,86.23
Portugal,2033,63,65013,75798,140811,85.7714
Portugal,2033,64,64084,75158,139242,85.2657
Portugal,2033,65,62980,75629,138609,83.2749
Portugal,2033,66,63325,76313,139638,82.9806
Portugal,2033,67,63329,76556,139885,82.7225
Portugal,2033,68,63059,77205,140264,81.6774
Portugal,2033,69,60870,74992,135862,81.1687
Portugal,2033,70,60026,74322,134348,80.7648
Portugal,2033,71,58993,73497,132490,80.2659
Portugal,2033,72,58358,72027,130385,81.0224
Portugal,2033,73,54375,68537,122912,79.3367
Portugal,2033,74,53203,67997,121200,78.2432
Portugal,2033,75,51576,66230,117806,77.8741
Portugal,2033,76,48880,63476,112356,77.0055
Portugal,2033,77,47663,63452,111115,75.1166
Portugal,2033,78,45001,59988,104989,75.0167
Portugal,2033,79,42022,57653,99675,72.8878
Portugal,2033,80,41090,57485,98575,71.4795
Portugal,2033,81,39679,54844,94523,72.3488
Portugal,2033,82,36868,52066,88934,70.8101
Portugal,2033,83,33642,48421,82063,69.4781
Portugal,2033,84,31360,47851,79211,65.5368
Portugal,2033,85,25704,40698,66402,63.1579
Portugal,2033,86,22913,37931,60844,60.4071
Portugal,2033,87,21004,36228,57232,57.9773
Portugal,2033,88,17137,30784,47921,55.6685
Portugal,2033,89,14196,26215,40411,54.1522
Portugal,2033,90,11134,21612,32746,51.5177
Portugal,2033,91,9073,18258,27331,49.6933
Portugal,2033,92,7369,15723,23092,46.8676
Portugal,2033,93,5784,13187,18971,43.8614
Portugal,2033,94,4499,10683,15182,42.1136
Portugal,2033,95,3141,8242,11383,38.1097
Portugal,2033,96,2397,6575,8972,36.4563
Portugal,2033,97,1611,4865,6476,33.1141
Portugal,2033,98,1019,3190,4209,31.9436
Portugal,2033,99,638,2224,2862,28.6871
Portugal,2033,100,857,3323,4180,25.7899
Portugal,2034,0,40348,38008,78356,106.1566
Portugal,2034,1,40236,37919,78155,106.1104
Portugal,2034,2,40432,38117,78549,106.0734
Portugal,2034,3,40420,38130,78550,106.0058
Portugal,2034,4,40411,38134,78545,105.971
Portugal,2034,5,40486,38229,78715,105.9039
Portugal,2034,6,40484,38254,78738,105.8295
Portugal,2034,7,40566,38355,78921,105.7646
Portugal,2034,8,40594,38414,79008,105.675
Portugal,2034,9,40874,38713,79587,105.5821
Portugal,2034,10,41129,38995,80124,105.4725
Portugal,2034,11,41404,39307,80711,105.3349
Portugal,2034,12,41751,39696,81447,105.1768
Portugal,2034,13,43915,41682,85597,105.3572
Portugal,2034,14,45248,42950,88198,105.3504
Portugal,2034,15,45068,43767,88835,102.9726
Portugal,2034,16,45059,43476,88535,103.6411
Portugal,2034,17,45941,43838,89779,104.7972
Portugal,2034,18,45090,43534,88624,103.5742
Portugal,2034,19,43961,41714,85675,105.3867
Portugal,2034,20,43882,42414,86296,103.4611
Portugal,2034,21,47869,45496,93365,105.2158
Portugal,2034,22,50950,48687,99637,104.6481
Portugal,2034,23,52372,51360,103732,101.9704
Portugal,2034,24,51011,49498,100509,103.0567
Portugal,2034,25,53560,51329,104889,104.3465
Portugal,2034,26,52605,50783,103388,103.5878
Portugal,2034,27,53936,52519,106455,102.6981
Portugal,2034,28,56602,54211,110813,104.4105
Portugal,2034,29,55588,53963,109551,103.0113
Portugal,2034,30,57152,55263,112415,103.4182
Portugal,2034,31,57854,55747,113601,103.7796
Portugal,2034,32,57732,55692,113424,103.663
Portugal,2034,33,62173,60327,122500,103.06
Portugal,2034,34,60413,59293,119706,101.8889
Portugal,2034,35,58535,57360,115895,102.0485
Portugal,2034,36,57562,57175,114737,100.6769
Portugal,2034,37,57195,55648,112843,102.78
Portugal,2034,38,56041,54953,110994,101.9799
Portugal,2034,39,55059,54725,109784,100.6103
Portugal,2034,40,56293,57078,113371,98.6247
Portugal,2034,41,56166,57437,113603,97.7871
Portugal,2034,42,57105,57899,115004,98.6286
Portugal,2034,43,56725,57891,114616,97.9859
Portugal,2034,44,56099,57266,113365,97.9621
Portugal,2034,45,56498,58163,114661,97.1374
Portugal,2034,46,56067,58382,114449,96.0347
Portugal,2034,47,56458,59554,116012,94.8014
Portugal,2034,48,57668,61169,118837,94.2765
Portugal,2034,49,61184,65688,126872,93.1433
Portugal,2034,50,62190,67270,129460,92.4483
Portugal,2034,51,64503,70903,135406,90.9736
Portugal,2034,52,64543,71799,136342,89.894
Portugal,2034,53,67298,74959,142257,89.7797
Portugal,2034,54,67052,74776,141828,89.6705
Portugal,2034,55,68422,77276,145698,88.5424
Portugal,2034,56,74064,83190,157254,89.0299
Portugal,2034,57,75001,85296,160297,87.9303
Portugal,2034,58,75029,85011,160040,88.258
Portugal,2034,59,72771,84245,157016,86.3802
Portugal,2034,60,70334,81564,151898,86.2317
Portugal,2034,61,69903,81692,151595,85.569
Portugal,2034,62,68890,80548,149438,85.5266
Portugal,2034,63,66524,77564,144088,85.7666
Portugal,2034,64,64411,75514,139925,85.2968
Portugal,2034,65,63465,74852,138317,84.7873
Portugal,2034,66,62339,75298,137637,82.7897
Portugal,2034,67,62634,75951,138585,82.4663
Portugal,2034,68,62579,76154,138733,82.1743
Portugal,2034,69,62241,76745,138986,81.101
Portugal,2034,70,60018,74495,134513,80.5665
Portugal,2034,71,59116,73775,132891,80.1301
Portugal,2034,72,58017,72892,130909,79.5931
Portugal,2034,73,57307,71364,128671,80.3024
Portugal,2034,74,53296,67824,121120,78.5799
Portugal,2034,75,52046,67200,119246,77.4494
Portugal,2034,76,50334,65348,115682,77.0245
Portugal,2034,77,47561,62500,110061,76.0976
Portugal,2034,78,46221,62320,108541,74.1672
Portugal,2034,79,43464,58736,102200,73.9989
Portugal,2034,80,40391,56243,96634,71.8152
Portugal,2034,81,39247,55824,95071,70.3049
Portugal,2034,82,37631,52990,90621,71.0153
Portugal,2034,83,34704,50029,84733,69.3678
Portugal,2034,84,31388,46212,77600,67.9218
Portugal,2034,85,28948,45265,74213,63.9523
Portugal,2034,86,23416,38058,61474,61.5271
Portugal,2034,87,20578,35024,55602,58.754
Portugal,2034,88,18566,33014,51580,56.2367
Portugal,2034,89,14836,27611,42447,53.7322
Portugal,2034,90,12030,23102,35132,52.0734
Portugal,2034,91,9248,18690,27938,49.481
Portugal,2034,92,7395,15510,22905,47.6789
Portugal,2034,93,5895,13142,19037,44.8562
Portugal,2034,94,4509,10785,15294,41.8081
Portugal,2034,95,3394,8491,11885,39.9717
Portugal,2034,96,2289,6342,8631,36.0927
Portugal,2034,97,1690,4895,6585,34.525
Portugal,2034,98,1097,3502,4599,31.325
Portugal,2034,99,669,2216,2885,30.1895
Portugal,2034,100,907,3529,4436,25.7013
Portugal,2035,0,40284,37944,78228,106.167
Portugal,2035,1,40403,38066,78469,106.1393
Portugal,2035,2,40289,37973,78262,106.0991
Portugal,2035,3,40479,38164,78643,106.0659
Portugal,2035,4,40460,38170,78630,105.9995
Portugal,2035,5,40445,38168,78613,105.9657
Portugal,2035,6,40514,38258,78772,105.8968
Portugal,2035,7,40509,38278,78787,105.8284
Portugal,2035,8,40587,38375,78962,105.7642
Portugal,2035,9,40612,38431,79043,105.6751
Portugal,2035,10,40889,38729,79618,105.5772
Portugal,2035,11,41144,39012,80156,105.465
Portugal,2035,12,41422,39327,80749,105.3271
Portugal,2035,13,41777,39725,81502,105.1655
Portugal,2035,14,43953,41725,85678,105.3397
Portugal,2035,15,45303,43013,88316,105.324
Portugal,2035,16,45143,43854,88997,102.9393
Portugal,2035,17,45157,43588,88745,103.5996
Portugal,2035,18,46060,43975,90035,104.7413
Portugal,2035,19,45229,43692,88921,103.5178
Portugal,2035,20,44115,41890,86005,105.3115
Portugal,2035,21,44050,42603,86653,103.3965
Portugal,2035,22,48046,45694,93740,105.1473
Portugal,2035,23,51130,48888,100018,104.586
Portugal,2035,24,52552,51559,104111,101.9259
Portugal,2035,25,51189,49695,100884,103.0063
Portugal,2035,26,53731,51519,105250,104.2936
Portugal,2035,27,52769,50965,103734,103.5397
Portugal,2035,28,54090,52690,106780,102.6571
Portugal,2035,29,56745,54370,111115,104.3682
Portugal,2035,30,55721,54110,109831,102.9773
Portugal,2035,31,57274,55398,112672,103.3864
Portugal,2035,32,57967,55871,113838,103.7515
Portugal,2035,33,57835,55805,113640,103.6377
Portugal,2035,34,62260,60427,122687,103.0334
Portugal,2035,35,60488,59383,119871,101.8608
Portugal,2035,36,58603,57441,116044,102.0229
Portugal,2035,37,57621,57246,114867,100.6551
Portugal,2035,38,57243,55709,112952,102.7536
Portugal,2035,39,56077,55005,111082,101.9489
Portugal,2035,40,55081,54766,109847,100.5752
Portugal,2035,41,56301,57108,113409,98.5869
Portugal,2035,42,56161,57458,113619,97.7427
Portugal,2035,43,57085,57911,114996,98.5737
Portugal,2035,44,56691,57897,114588,97.917
Portugal,2035,45,56051,57263,113314,97.8835
Portugal,2035,46,56432,58149,114581,97.0472
Portugal,2035,47,55983,58358,114341,95.9303
Portugal,2035,48,56355,59519,115874,94.6841
Portugal,2035,49,57543,61122,118665,94.1445
Portugal,2035,50,61026,65626,126652,92.9906
Portugal,2035,51,62001,67196,129197,92.2689
Portugal,2035,52,64276,70810,135086,90.7725
Portugal,2035,53,64291,71691,135982,89.6779
Portugal,2035,54,67011,74837,141848,89.5426
Portugal,2035,55,66742,74646,141388,89.4114
Portugal,2035,56,68076,77127,145203,88.2648
Portugal,2035,57,73653,83014,156667,88.7236
Portugal,2035,58,74550,85103,159653,87.5997
Portugal,2035,59,74535,84800,159335,87.895
Portugal,2035,60,72249,84012,156261,85.9984
Portugal,2035,61,69784,81314,151098,85.8204
Portugal,2035,62,69319,81426,150745,85.1313
Portugal,2035,63,68290,80273,148563,85.0722
Portugal,2035,64,65919,77279,143198,85.3
Portugal,2035,65,63800,75213,139013,84.8258
Portugal,2035,66,62831,74531,137362,84.3018
Portugal,2035,67,61671,74947,136618,82.2861
Portugal,2035,68,61906,75560,137466,81.9296
Portugal,2035,69,61782,75710,137492,81.6035
Portugal,2035,70,61386,76247,137633,80.5094
Portugal,2035,71,59125,73958,133083,79.944
Portugal,2035,72,58156,73181,131337,79.4687
Portugal,2035,73,56992,72236,129228,78.8969
Portugal,2035,74,56191,70638,126829,79.5478
Portugal,2035,75,52160,67047,119207,77.7962
Portugal,2035,76,50817,66326,117143,76.617
Portugal,2035,77,49002,64366,113368,76.1303
Portugal,2035,78,46150,61410,107560,75.1506
Portugal,2035,79,44671,61047,105718,73.1748
Portugal,2035,80,41805,57329,99134,72.9212
Portugal,2035,81,38607,54648,93255,70.6467
Portugal,2035,82,37251,53970,91221,69.0217
Portugal,2035,83,35454,50953,86407,69.5818
Portugal,2035,84,32411,47784,80195,67.8281
Portugal,2035,85,29005,43753,72758,66.2926
Portugal,2035,86,26401,42369,68770,62.3121
Portugal,2035,87,21054,35177,56231,59.8516
Portugal,2035,88,18213,31953,50166,56.9993
Portugal,2035,89,16094,29646,45740,54.2873
Portugal,2035,90,12589,24362,36951,51.6747
Portugal,2035,91,10006,20003,30009,50.0225
Portugal,2035,92,7548,15897,23445,47.4807
Portugal,2035,93,5925,12983,18908,45.6366
Portugal,2035,94,4603,10765,15368,42.7589
Portugal,2035,95,3406,8584,11990,39.6785
Portugal,2035,96,2477,6543,9020,37.8573
Portugal,2035,97,1616,4728,6344,34.1794
Portugal,2035,98,1153,3528,4681,32.6814
Portugal,2035,99,721,2435,3156,29.6099
Portugal,2035,100,955,3649,4604,26.1716
Portugal,2036,0,40154,37812,77966,106.1938
Portugal,2036,1,40340,38002,78342,106.1523
Portugal,2036,2,40456,38121,78577,106.1252
Portugal,2036,3,40336,38020,78356,106.0915
Portugal,2036,4,40518,38204,78722,106.057
Portugal,2036,5,40493,38204,78697,105.9915
Portugal,2036,6,40473,38197,78670,105.9586
Portugal,2036,7,40539,38282,78821,105.8957
Portugal,2036,8,40530,38299,78829,105.8252
Portugal,2036,9,40605,38393,78998,105.7615
Portugal,2036,10,40627,38447,79074,105.6701
Portugal,2036,11,40904,38745,79649,105.5723
Portugal,2036,12,41162,39031,80193,105.4598
Portugal,2036,13,41448,39356,80804,105.3156
Portugal,2036,14,41815,39768,81583,105.1474
Portugal,2036,15,44008,41788,85796,105.3125
Portugal,2036,16,45378,43100,88478,105.2854
Portugal,2036,17,45240,43966,89206,102.8977
Portugal,2036,18,45276,43725,89001,103.5472
Portugal,2036,19,46199,44134,90333,104.6789
Portugal,2036,20,45383,43869,89252,103.4512
Portugal,2036,21,44284,42080,86364,105.2376
Portugal,2036,22,44228,42802,87030,103.3316
Portugal,2036,23,48227,45894,94121,105.0835
Portugal,2036,24,51311,49088,100399,104.5286
Portugal,2036,25,52729,51756,104485,101.88
Portugal,2036,26,51361,49886,101247,102.9567
Portugal,2036,27,53895,51702,105597,104.2416
Portugal,2036,28,52924,51137,104061,103.4945
Portugal,2036,29,54234,52850,107084,102.6187
Portugal,2036,30,56878,54517,111395,104.3308
Portugal,2036,31,55845,54246,110091,102.9477
Portugal,2036,32,57388,55523,112911,103.359
Portugal,2036,33,58070,55984,114054,103.7261
Portugal,2036,34,57924,55906,113830,103.6096
Portugal,2036,35,62335,60516,122851,103.0058
Portugal,2036,36,60555,59463,120018,101.8364
Portugal,2036,37,58662,57513,116175,101.9978
Portugal,2036,38,57669,57307,114976,100.6317
Portugal,2036,39,57278,55760,113038,102.7224
Portugal,2036,40,56099,55047,111146,101.9111
Portugal,2036,41,55091,54799,109890,100.5329
Portugal,2036,42,56296,57130,113426,98.5402
Portugal,2036,43,56143,57471,113614,97.6893
Portugal,2036,44,57052,57917,114969,98.5065
Portugal,2036,45,56644,57894,114538,97.8409
Portugal,2036,46,55988,57251,113239,97.7939
Portugal,2036,47,56349,58127,114476,96.9412
Portugal,2036,48,55883,58325,114208,95.8131
Portugal,2036,49,56235,59475,115710,94.5523
Portugal,2036,50,57399,61067,118466,93.9935
Portugal,2036,51,60845,65555,126400,92.8152
Portugal,2036,52,61788,67110,128898,92.0697
Portugal,2036,53,64029,70706,134735,90.5567
Portugal,2036,54,64021,71577,135598,89.4435
Portugal,2036,55,66706,74709,141415,89.2878
Portugal,2036,56,66411,74505,140916,89.1363
Portugal,2036,57,67706,76968,144674,87.9664
Portugal,2036,58,73217,82830,156047,88.3943
Portugal,2036,59,74067,84896,158963,87.2444
Portugal,2036,60,74008,84569,158577,87.512
Portugal,2036,61,71691,83759,155450,85.592
Portugal,2036,62,69210,81054,150264,85.3875
Portugal,2036,63,68725,81152,149877,84.6868
Portugal,2036,64,67678,79983,147661,84.6155
Portugal,2036,65,65304,76978,142282,84.8346
Portugal,2036,66,63174,74897,138071,84.3478
Portugal,2036,67,62169,74192,136361,83.7947
Portugal,2036,68,60967,74571,135538,81.757
Portugal,2036,69,61131,75129,136260,81.368
Portugal,2036,70,60949,75230,136179,81.0169
Portugal,2036,71,60490,75710,136200,79.897
Portugal,2036,72,58184,73376,131560,79.2957
Portugal,2036,73,57149,72538,129687,78.7849
Portugal,2036,74,55905,71518,127423,78.1691
Portugal,2036,75,55016,69847,124863,78.7664
Portugal,2036,76,50953,66194,117147,76.9753
Portugal,2036,77,49498,65351,114849,75.7418
Portugal,2036,78,47575,63268,110843,75.196
Portugal,2036,79,44630,60182,104812,74.1584
Portugal,2036,80,42996,59614,102610,72.124
Portugal,2036,81,39988,55733,95721,71.7492
Portugal,2036,82,36673,52865,89538,69.371
Portugal,2036,83,35127,51930,87057,67.643
Portugal,2036,84,33144,48703,81847,68.0533
Portugal,2036,85,29982,45279,75261,66.2161
Portugal,2036,86,26483,40992,67475,64.6053
Portugal,2036,87,23766,39202,62968,60.6245
Portugal,2036,88,18658,32129,50787,58.0721
Portugal,2036,89,15809,28727,44536,55.0319
Portugal,2036,90,13676,26189,39865,52.2204
Portugal,2036,91,10486,21121,31607,49.6473
Portugal,2036,92,8178,17037,25215,48.0014
Portugal,2036,93,6058,13326,19384,45.46
Portugal,2036,94,4633,10650,15283,43.5023
Portugal,2036,95,3483,8581,12064,40.5897
Portugal,2036,96,2489,6624,9113,37.5755
Portugal,2036,97,1751,4884,6635,35.8518
Portugal,2036,98,1104,3412,4516,32.3564
Portugal,2036,99,759,2457,3216,30.8913
Portugal,2036,100,1014,3872,4886,26.188
Portugal,2037,0,39872,37547,77419,106.1922
Portugal,2037,1,40210,37871,78081,106.1762
Portugal,2037,2,40393,38057,78450,106.1382
Portugal,2037,3,40503,38168,78671,106.1177
Portugal,2037,4,40375,38060,78435,106.0825
Portugal,2037,5,40552,38238,78790,106.0516
Portugal,2037,6,40522,38233,78755,105.987
Portugal,2037,7,40498,38222,78720,105.9547
Portugal,2037,8,40560,38303,78863,105.8925
Portugal,2037,9,40547,38317,78864,105.8199
Portugal,2037,10,40620,38409,79029,105.7565
Portugal,2037,11,40642,38463,79105,105.6652
Portugal,2037,12,40923,38765,79688,105.5669
Portugal,2037,13,41188,39060,80248,105.448
Portugal,2037,14,41486,39399,80885,105.2971
Portugal,2037,15,41871,39831,81702,105.1216
Portugal,2037,16,44083,41875,85958,105.2728
Portugal,2037,17,45476,43212,88688,105.2393
Portugal,2037,18,45360,44103,89463,102.8501
Portugal,2037,19,45415,43884,89299,103.4887
Portugal,2037,20,46354,44311,90665,104.6106
Portugal,2037,21,45552,44059,89611,103.3886
Portugal,2037,22,44462,42279,86741,105.1633
Portugal,2037,23,44410,43003,87413,103.2719
Portugal,2037,24,48409,46095,94504,105.0201
Portugal,2037,25,51489,49285,100774,104.4719
Portugal,2037,26,52902,51947,104849,101.8384
Portugal,2037,27,51526,50069,101595,102.91
Portugal,2037,28,54050,51873,105923,104.1968
Portugal,2037,29,53069,51297,104366,103.4544
Portugal,2037,30,54369,52998,107367,102.5869
Portugal,2037,31,57001,54654,111655,104.2943
Portugal,2037,32,55959,54371,110330,102.9207
Portugal,2037,33,57492,55636,113128,103.336
Portugal,2037,34,58160,56086,114246,103.6979
Portugal,2037,35,58002,55998,114000,103.5787
Portugal,2037,36,62401,60597,122998,102.977
Portugal,2037,37,60614,59535,120149,101.8124
Portugal,2037,38,58710,57574,116284,101.9731
Portugal,2037,39,57705,57358,115063,100.605
Portugal,2037,40,57300,55803,113103,102.6827
Portugal,2037,41,56109,55080,111189,101.8682
Portugal,2037,42,55089,54822,109911,100.487
Portugal,2037,43,56280,57144,113424,98.488
Portugal,2037,44,56113,57478,113591,97.6252
Portugal,2037,45,57005,57916,114921,98.427
Portugal,2037,46,56581,57882,114463,97.7523
Portugal,2037,47,55907,57230,113137,97.6883
Portugal,2037,48,56250,58095,114345,96.8242
Portugal,2037,49,55767,58284,114051,95.6815
Portugal,2037,50,56098,59424,115522,94.4029
Portugal,2037,51,57233,61004,118237,93.8184
Portugal,2037,52,60639,65474,126113,92.6154
Portugal,2037,53,61555,67015,128570,91.8526
Portugal,2037,54,63764,70596,134360,90.3224
Portugal,2037,55,63735,71458,135193,89.1923
Portugal,2037,56,66379,74571,140950,89.0145
Portugal,2037,57,66055,74355,140410,88.8373
Portugal,2037,58,67312,76802,144114,87.6436
Portugal,2037,59,72749,82633,155382,88.0387
Portugal,2037,60,73550,84669,158219,86.8677
Portugal,2037,61,73444,84319,157763,87.1026
Portugal,2037,62,71110,83496,154606,85.1658
Portugal,2037,63,68626,80787,149413,84.9468
Portugal,2037,64,68120,80865,148985,84.2392
Portugal,2037,65,67058,79677,146735,84.1623
Portugal,2037,66,64674,76661,141335,84.3636
Portugal,2037,67,62521,74564,137085,83.8488
Portugal,2037,68,61473,73827,135300,83.2663
Portugal,2037,69,60219,74155,134374,81.2069
Portugal,2037,70,60323,74663,134986,80.7937
Portugal,2037,71,60076,74712,134788,80.4101
Portugal,2037,72,59544,75128,134672,79.2567
Portugal,2037,73,57195,72746,129941,78.6229
Portugal,2037,74,56079,71833,127912,78.0686
Portugal,2037,75,54759,70736,125495,77.4132
Portugal,2037,76,53768,68979,122747,77.9484
Portugal,2037,77,49655,65243,114898,76.1078
Portugal,2037,78,48084,64260,112344,74.8273
Portugal,2037,79,46037,62030,108067,74.2173
Portugal,2037,80,42985,58798,101783,73.1062
Portugal,2037,81,41156,57985,99141,70.977
Portugal,2037,82,38014,53946,91960,70.4668
Portugal,2037,83,34612,50901,85513,67.9987
Portugal,2037,84,32869,49674,82543,66.1694
Portugal,2037,85,30692,46189,76881,66.4487
Portugal,2037,86,27405,42462,69867,64.5401
Portugal,2037,87,23868,37967,61835,62.8651
Portugal,2037,88,21088,35845,56933,58.8311
Portugal,2037,89,16217,28918,45135,56.0793
Portugal,2037,90,13452,25409,38861,52.9419
Portugal,2037,91,11407,22735,34142,50.1737
Portugal,2037,92,8583,18013,26596,47.6489
Portugal,2037,93,6573,14302,20875,45.9586
Portugal,2037,94,4744,10948,15692,43.3321
Portugal,2037,95,3511,8501,12012,41.301
Portugal,2037,96,2549,6631,9180,38.4407
Portugal,2037,97,1762,4952,6714,35.5816
Portugal,2037,98,1198,3529,4727,33.9473
Portugal,2037,99,728,2379,3107,30.6011
Portugal,2037,100,1075,4028,5103,26.6882
Portugal,2038,0,39532,37223,76755,106.2032
Portugal,2038,1,39928,37606,77534,106.1745
Portugal,2038,2,40264,37926,78190,106.1646
Portugal,2038,3,40440,38104,78544,106.1306
Portugal,2038,4,40543,38208,78751,106.1113
Portugal,2038,5,40409,38094,78503,106.0771
Portugal,2038,6,40580,38267,78847,106.0444
Portugal,2038,7,40547,38258,78805,105.9831
Portugal,2038,8,40519,38243,78762,105.9514
Portugal,2038,9,40578,38321,78899,105.8897
Portugal,2038,10,40563,38332,78895,105.8202
Portugal,2038,11,40635,38425,79060,105.7515
Portugal,2038,12,40660,38483,79143,105.657
Portugal,2038,13,40949,38793,79742,105.5577
Portugal,2038,14,41227,39104,80331,105.4291
Portugal,2038,15,41542,39462,81004,105.2709
Portugal,2038,16,41946,39918,81864,105.0804
Portugal,2038,17,44181,41988,86169,105.2229
Portugal,2038,18,45596,43349,88945,105.1835
Portugal,2038,19,45499,44262,89761,102.7947
Portugal,2038,20,45571,44061,89632,103.4271
Portugal,2038,21,46522,44501,91023,104.5415
Portugal,2038,22,45730,44257,89987,103.3283
Portugal,2038,23,44645,42480,87125,105.0965
Portugal,2038,24,44593,43204,87797,103.215
Portugal,2038,25,48588,46293,94881,104.9576
Portugal,2038,26,51663,49476,101139,104.4203
Portugal,2038,27,53067,52129,105196,101.7994
Portugal,2038,28,51682,50241,101923,102.8682
Portugal,2038,29,54195,52033,106228,104.1551
Portugal,2038,30,53204,51445,104649,103.4192
Portugal,2038,31,54493,53134,107627,102.5577
Portugal,2038,32,57116,54779,111895,104.2662
Portugal,2038,33,56064,54485,110549,102.898
Portugal,2038,34,57582,55738,113320,103.3083
Portugal,2038,35,58238,56178,114416,103.6669
Portugal,2038,36,58071,56080,114151,103.5503
Portugal,2038,37,62459,60668,123127,102.9521
Portugal,2038,38,60661,59596,120257,101.787
Portugal,2038,39,58746,57625,116371,101.9453
Portugal,2038,40,57728,57400,115128,100.5714
Portugal,2038,41,57309,55836,113145,102.6381
Portugal,2038,42,56106,55103,111209,101.8202
Portugal,2038,43,55075,54839,109914,100.4304
Portugal,2038,44,56250,57152,113402,98.4218
Portugal,2038,45,56069,57477,113546,97.5503
Portugal,2038,46,56943,57905,114848,98.3387
Portugal,2038,47,56501,57862,114363,97.6479
Portugal,2038,48,55811,57201,113012,97.57
Portugal,2038,49,56134,58055,114189,96.6911
Portugal,2038,50,55633,58235,113868,95.5319
Portugal,2038,51,55939,59365,115304,94.2289
Portugal,2038,52,57044,60932,117976,93.6191
Portugal,2038,53,60414,65383,125797,92.4002
Portugal,2038,54,61305,66914,128219,91.6176
Portugal,2038,55,63484,70481,133965,90.0725
Portugal,2038,56,63428,71329,134757,88.9232
Portugal,2038,57,66029,74423,140452,88.7212
Portugal,2038,58,65676,74197,139873,88.5157
Portugal,2038,59,66889,76623,143512,87.2962
Portugal,2038,60,72249,82415,154664,87.6649
Portugal,2038,61,72998,84422,157420,86.468
Portugal,2038,62,72857,84058,156915,86.6747
Portugal,2038,63,70519,83225,153744,84.733
Portugal,2038,64,68031,80506,148537,84.5043
Portugal,2038,65,67505,80561,148066,83.7936
Portugal,2038,66,66421,79354,145775,83.7021
Portugal,2038,67,64016,76325,140341,83.8729
Portugal,2038,68,61833,74204,136037,83.3284
Portugal,2038,69,60731,73423,134154,82.7139
Portugal,2038,70,59436,73703,133139,80.6426
Portugal,2038,71,59474,74159,133633,80.198
Portugal,2038,72,59153,74148,133301,79.7769
Portugal,2038,73,58551,74494,133045,78.5983
Portugal,2038,74,56144,72052,128196,77.9215
Portugal,2038,75,54951,71063,126014,77.3272
Portugal,2038,76,53539,69874,123413,76.6222
Portugal,2038,77,52423,68007,120430,77.0847
Portugal,2038,78,48261,64176,112437,75.201
Portugal,2038,79,46555,63026,109581,73.8663
Portugal,2038,80,44367,60628,104995,73.1791
Portugal,2038,81,41173,57217,98390,71.9594
Portugal,2038,82,39152,56154,95306,69.7225
Portugal,2038,83,35906,51971,87877,69.0885
Portugal,2038,84,32416,48721,81137,66.5339
Portugal,2038,85,30467,47144,77611,64.6254
Portugal,2038,86,28083,43350,71433,64.782
Portugal,2038,87,24726,39362,64088,62.8169
Portugal,2038,88,21203,34748,55951,61.0193
Portugal,2038,89,18351,32295,50646,56.823
Portugal,2038,90,13817,25605,39422,53.9621
Portugal,2038,91,11235,22081,33316,50.8808
Portugal,2038,92,9348,19410,28758,48.1607
Portugal,2038,93,6908,15140,22048,45.6275
Portugal,2038,94,5155,11764,16919,43.8201
Portugal,2038,95,3600,8750,12350,41.1429
Portugal,2038,96,2573,6577,9150,39.1212
Portugal,2038,97,1807,4963,6770,36.4094
Portugal,2038,98,1207,3582,4789,33.6963
Portugal,2038,99,790,2463,3253,32.0747
Portugal,2038,100,1092,4069,5161,26.8371
Portugal,2039,0,39443,37134,76577,106.218
Portugal,2039,1,39589,37282,76871,106.188
Portugal,2039,2,39982,37661,77643,106.1629
Portugal,2039,3,40311,37973,78284,106.157
Portugal,2039,4,40480,38144,78624,106.1242
Portugal,2039,5,40576,38242,78818,106.1032
Portugal,2039,6,40438,38123,78561,106.0724
Portugal,2039,7,40605,38291,78896,106.0432
Portugal,2039,8,40568,38279,78847,105.9798
Portugal,2039,9,40537,38260,78797,105.9514
Portugal,2039,10,40593,38337,78930,105.8847
Portugal,2039,11,40578,38349,78927,105.8124
Portugal,2039,12,40654,38445,79099,105.7459
Portugal,2039,13,40686,38512,79198,105.645
Portugal,2039,14,40987,38837,79824,105.536
Portugal,2039,15,41282,39167,80449,105.4
Portugal,2039,16,41618,39549,81167,105.2315
Portugal,2039,17,42044,40031,82075,105.0286
Portugal,2039,18,44301,42125,86426,105.1656
Portugal,2039,19,45735,43509,89244,105.1162
Portugal,2039,20,45654,44439,90093,102.7341
Portugal,2039,21,45739,44251,89990,103.3626
Portugal,2039,22,46700,44699,91399,104.4766
Portugal,2039,23,45912,44458,90370,103.2705
Portugal,2039,24,44828,42682,87510,105.0279
Portugal,2039,25,44774,43402,88176,103.1611
Portugal,2039,26,48762,46485,95247,104.8984
Portugal,2039,27,51828,49659,101487,104.3678
Portugal,2039,28,53222,52301,105523,101.761
Portugal,2039,29,51828,50401,102229,102.8313
Portugal,2039,30,54330,52182,106512,104.1164
Portugal,2039,31,53330,51582,104912,103.3888
Portugal,2039,32,54610,53260,107870,102.5347
Portugal,2039,33,57221,54893,112114,104.241
Portugal,2039,34,56156,54588,110744,102.8724
Portugal,2039,35,57661,55830,113491,103.2796
Portugal,2039,36,58308,56260,114568,103.6402
Portugal,2039,37,58133,56153,114286,103.5261
Portugal,2039,38,62506,60729,123235,102.9261
Portugal,2039,39,60696,59647,120343,101.7587
Portugal,2039,40,58768,57668,116436,101.9075
Portugal,2039,41,57737,57433,115170,100.5293
Portugal,2039,42,57307,55860,113167,102.5904
Portugal,2039,43,56092,55121,111213,101.7616
Portugal,2039,44,55048,54849,109897,100.3628
Portugal,2039,45,56208,57152,113360,98.3483
Portugal,2039,46,56011,57468,113479,97.4647
Portugal,2039,47,56864,57885,114749,98.2362
Portugal,2039,48,56405,57833,114238,97.5308
Portugal,2039,49,55699,57163,112862,97.4389
Portugal,2039,50,56002,58009,114011,96.5402
Portugal,2039,51,55478,58180,113658,95.3558
Portugal,2039,52,55757,59297,115054,94.0301
Portugal,2039,53,56836,60851,117687,93.4019
Portugal,2039,54,60172,65287,125459,92.1654
Portugal,2039,55,61040,66807,127847,91.3677
Portugal,2039,56,63182,70355,133537,89.8046
Portugal,2039,57,63099,71190,134289,88.6346
Portugal,2039,58,65655,74268,139923,88.4028
Portugal,2039,59,65270,74027,139297,88.1705
Portugal,2039,60,66437,76425,142862,86.931
Portugal,2039,61,71714,82179,153893,87.2656
Portugal,2039,62,72422,84165,156587,86.0476
Portugal,2039,63,72260,83790,156050,86.2394
Portugal,2039,64,69916,82941,152857,84.2961
Portugal,2039,65,67427,80209,147636,84.0641
Portugal,2039,66,66875,80242,147117,83.3416
Portugal,2039,67,65757,79015,144772,83.2209
Portugal,2039,68,63324,75965,139289,83.3594
Portugal,2039,69,61098,73806,134904,82.7819
Portugal,2039,70,59955,72986,132941,82.1459
Portugal,2039,71,58614,73217,131831,80.0552
Portugal,2039,72,58577,73612,132189,79.5753
Portugal,2039,73,58184,73538,131722,79.121
Portugal,2039,74,57494,73801,131295,77.9041
Portugal,2039,75,55035,71299,126334,77.189
Portugal,2039,76,53748,70218,123966,76.5445
Portugal,2039,77,52223,68912,121135,75.7822
Portugal,2039,78,50977,66919,117896,76.1772
Portugal,2039,79,46753,62970,109723,74.2465
Portugal,2039,80,44894,61631,106525,72.8432
Portugal,2039,81,42524,59029,101553,72.0392
Portugal,2039,82,39196,55442,94638,70.6973
Portugal,2039,83,37010,54134,91144,68.3674
Portugal,2039,84,33657,49782,83439,67.6088
Portugal,2039,85,30075,46278,76353,64.9877
Portugal,2039,86,27905,44287,72192,63.0095
Portugal,2039,87,25364,40226,65590,63.0537
Portugal,2039,88,21990,36065,58055,60.9732
Portugal,2039,89,18474,31343,49817,58.9414
Portugal,2039,90,15654,28629,44283,54.6788
Portugal,2039,91,11554,22279,33833,51.8605
Portugal,2039,92,9219,18877,28096,48.8372
Portugal,2039,93,7535,16338,23873,46.1195
Portugal,2039,94,5426,12472,17898,43.5055
Portugal,2039,95,3918,9417,13335,41.6056
Portugal,2039,96,2642,6780,9422,38.9676
Portugal,2039,97,1826,4930,6756,37.0385
Portugal,2039,98,1239,3595,4834,34.4645
Portugal,2039,99,797,2503,3300,31.8418
Portugal,2039,100,1142,4153,5295,27.4982
Portugal,2040,0,39171,36874,76045,106.2293
Portugal,2040,1,39500,37194,76694,106.1999
Portugal,2040,2,39643,37337,76980,106.1762
Portugal,2040,3,40029,37708,77737,106.1552
Portugal,2040,4,40351,38013,78364,106.1505
Portugal,2040,5,40514,38178,78692,106.1187
Portugal,2040,6,40605,38271,78876,106.0986
Portugal,2040,7,40462,38148,78610,106.0658
Portugal,2040,8,40626,38312,78938,106.0399
Portugal,2040,9,40586,38296,78882,105.9797
Portugal,2040,10,40552,38276,78828,105.9463
Portugal,2040,11,40608,38353,78961,105.8796
Portugal,2040,12,40596,38369,78965,105.8042
Portugal,2040,13,40680,38474,79154,105.7337
Portugal,2040,14,40725,38555,79280,105.6283
Portugal,2040,15,41043,38900,79943,105.509
Portugal,2040,16,41358,39254,80612,105.36
Portugal,2040,17,41716,39662,81378,105.1788
Portugal,2040,18,42165,40169,82334,104.969
Portugal,2040,19,44441,42285,86726,105.0987
Portugal,2040,20,45891,43685,89576,105.0498
Portugal,2040,21,45823,44629,90452,102.6754
Portugal,2040,22,45918,44450,90368,103.3026
Portugal,2040,23,46883,44901,91784,104.4142
Portugal,2040,24,46095,44660,90755,103.2132
Portugal,2040,25,45009,42880,87889,104.965
Portugal,2040,26,44950,43595,88545,103.1082
Portugal,2040,27,48929,46668,95597,104.8449
Portugal,2040,28,51985,49832,101817,104.3205
Portugal,2040,29,53368,52462,105830,101.727
Portugal,2040,30,51965,50550,102515,102.7992
Portugal,2040,31,54455,52319,106774,104.0826
Portugal,2040,32,53447,51708,105155,103.3631
Portugal,2040,33,54716,53375,108091,102.5124
Portugal,2040,34,57312,54996,112308,104.2112
Portugal,2040,35,56236,54681,110917,102.8438
Portugal,2040,36,57732,55913,113645,103.2533
Portugal,2040,37,58369,56334,114703,103.6124
Portugal,2040,38,58183,56216,114399,103.499
Portugal,2040,39,62541,60780,123321,102.8973
Portugal,2040,40,60718,59689,120407,101.7239
Portugal,2040,41,58778,57701,116479,101.8665
Portugal,2040,42,57735,57456,115191,100.4856
Portugal,2040,43,57292,55877,113169,102.5323
Portugal,2040,44,56066,55131,111197,101.696
Portugal,2040,45,55009,54852,109861,100.2862
Portugal,2040,46,56150,57144,113294,98.2605
Portugal,2040,47,55935,57450,113385,97.3629
Portugal,2040,48,56769,57857,114626,98.1195
Portugal,2040,49,56294,57795,114089,97.4029
Portugal,2040,50,55570,57119,112689,97.2881
Portugal,2040,51,55848,57954,113802,96.3661
Portugal,2040,52,55301,58115,113416,95.1579
Portugal,2040,53,55558,59220,114778,93.8163
Portugal,2040,54,56614,60764,117378,93.1703
Portugal,2040,55,59916,65185,125101,91.9169
Portugal,2040,56,60755,66691,127446,91.0992
Portugal,2040,57,62859,70221,133080,89.516
Portugal,2040,58,62748,71045,133793,88.3215
Portugal,2040,59,65255,74101,139356,88.0622
Portugal,2040,60,64835,73840,138675,87.8047
Portugal,2040,61,65953,76211,142164,86.54
Portugal,2040,62,71157,81934,153091,86.8467
Portugal,2040,63,71838,83903,155741,85.6203
Portugal,2040,64,71653,83510,155163,85.8017
Portugal,2040,65,69306,82642,151948,83.8629
Portugal,2040,66,66809,79899,146708,83.6168
Portugal,2040,67,66218,79906,146124,82.8699
Portugal,2040,68,65058,78650,143708,82.7184
Portugal,2040,69,62586,75567,138153,82.8219
Portugal,2040,70,60333,73377,133710,82.2233
Portugal,2040,71,59142,72515,131657,81.5583
Portugal,2040,72,57747,72689,130436,79.4439
Portugal,2040,73,57636,73020,130656,78.9318
Portugal,2040,74,57155,72869,130024,78.4353
Portugal,2040,75,56381,73047,129428,77.1846
Portugal,2040,76,53855,70471,124326,76.4215
Portugal,2040,77,52453,69273,121726,75.7193
Portugal,2040,78,50811,67835,118646,74.9038
Portugal,2040,79,49414,65690,115104,75.223
Portugal,2040,80,45114,61606,106720,73.2299
Portugal,2040,81,43058,60036,103094,71.7203
Portugal,2040,82,40513,57231,97744,70.7886
Portugal,2040,83,37083,53483,90566,69.3361
Portugal,2040,84,34724,51891,86615,66.9172
Portugal,2040,85,31259,47325,78584,66.0518
Portugal,2040,86,27577,43514,71091,63.375
Portugal,2040,87,25233,41136,66369,61.3404
Portugal,2040,88,22586,36897,59483,61.2136
Portugal,2040,89,19185,32569,51754,58.9057
Portugal,2040,90,15780,27819,43599,56.7238
Portugal,2040,91,13109,24942,38051,52.5579
Portugal,2040,92,9495,19072,28567,49.785
Portugal,2040,93,7442,15912,23354,46.7697
Portugal,2040,94,5928,13478,19406,43.9828
Portugal,2040,95,4130,9998,14128,41.3083
Portugal,2040,96,2879,7306,10185,39.406
Portugal,2040,97,1878,5088,6966,36.9104
Portugal,2040,98,1254,3576,4830,35.0671
Portugal,2040,99,819,2515,3334,32.5646
Portugal,2040,100,1176,4232,5408,27.7883
Portugal,2041,0,38794,36517,75311,106.2355
Portugal,2041,1,39229,36934,76163,106.2138
Portugal,2041,2,39554,37249,76803,106.1881
Portugal,2041,3,39690,37385,77075,106.1656
Portugal,2041,4,40069,37748,77817,106.1487
Portugal,2041,5,40384,38047,78431,106.1424
Portugal,2041,6,40542,38207,78749,106.1114
Portugal,2041,7,40630,38296,78926,106.0946
Portugal,2041,8,40484,38169,78653,106.0651
Portugal,2041,9,40644,38330,78974,106.037
Portugal,2041,10,40601,38312,78913,105.9746
Portugal,2041,11,40567,38293,78860,105.9384
Portugal,2041,12,40627,38373,79000,105.8739
Portugal,2041,13,40623,38398,79021,105.7946
Portugal,2041,14,40719,38518,79237,105.7142
Portugal,2041,15,40780,38619,79399,105.5957
Portugal,2041,16,41119,38987,80106,105.4685
Portugal,2041,17,41456,39367,80823,105.3065
Portugal,2041,18,41837,39800,81637,105.1181
Portugal,2041,19,42306,40328,82634,104.9048
Portugal,2041,20,44597,42462,87059,105.028
Portugal,2041,21,46060,43876,89936,104.9777
Portugal,2041,22,46002,44828,90830,102.6189
Portugal,2041,23,46101,44651,90752,103.2474
Portugal,2041,24,47066,45102,92168,104.3546
Portugal,2041,25,46276,44858,91134,103.1611
Portugal,2041,26,45185,43072,88257,104.9057
Portugal,2041,27,45119,43778,88897,103.0632
Portugal,2041,28,49087,46841,95928,104.7949
Portugal,2041,29,52131,49992,102123,104.2787
Portugal,2041,30,53504,52610,106114,101.6993
Portugal,2041,31,52092,50688,102780,102.7699
Portugal,2041,32,54572,52445,107017,104.0557
Portugal,2041,33,53554,51824,105378,103.3382
Portugal,2041,34,54809,53478,108287,102.4889
Portugal,2041,35,57393,55089,112482,104.1823
Portugal,2041,36,56308,54764,111072,102.8194
Portugal,2041,37,57794,55987,113781,103.2275
Portugal,2041,38,58420,56397,114817,103.5871
Portugal,2041,39,58221,56269,114490,103.4691
Portugal,2041,40,62562,60822,123384,102.8608
Portugal,2041,41,60727,59721,120448,101.6845
Portugal,2041,42,58775,57725,116500,101.819
Portugal,2041,43,57721,57473,115194,100.4315
Portugal,2041,44,57265,55888,113153,102.4639
Portugal,2041,45,56026,55135,111161,101.616
Portugal,2041,46,54955,54847,109802,100.1969
Portugal,2041,47,56076,57127,113203,98.1602
Portugal,2041,48,55845,57423,113268,97.252
Portugal,2041,49,56659,57821,114480,97.9903
Portugal,2041,50,56165,57752,113917,97.252
Portugal,2041,51,55420,57067,112487,97.1139
Portugal,2041,52,55673,57891,113564,96.1687
Portugal,2041,53,55107,58041,113148,94.945
Portugal,2041,54,55345,59138,114483,93.5862
Portugal,2041,55,56378,60672,117050,92.9226
Portugal,2041,56,59642,65075,124717,91.6512
Portugal,2041,57,60450,66568,127018,90.8094
Portugal,2041,58,62515,70081,132596,89.2039
Portugal,2041,59,62372,70889,133261,87.9854
Portugal,2041,60,64827,73917,138744,87.7024
Portugal,2041,61,64370,73637,138007,87.4153
Portugal,2041,62,65450,75989,141439,86.1309
Portugal,2041,63,70594,81684,152278,86.4233
Portugal,2041,64,71246,83628,154874,85.194
Portugal,2041,65,71039,83215,154254,85.368
Portugal,2041,66,68682,82328,151010,83.4248
Portugal,2041,67,66165,79571,145736,83.1522
Portugal,2041,68,65528,79545,145073,82.3785
Portugal,2041,69,64314,78247,142561,82.1936
Portugal,2041,70,61816,75137,136953,82.2711
Portugal,2041,71,59530,72915,132445,81.643
Portugal,2041,72,58284,72005,130289,80.9444
Portugal,2041,73,56838,72119,128957,78.8114
Portugal,2041,74,56637,72372,129009,78.2582
Portugal,2041,75,56071,72143,128214,77.722
Portugal,2041,76,55197,72219,127416,76.43
Portugal,2041,77,52583,69545,122128,75.61
Portugal,2041,78,51063,68216,119279,74.8549
Portugal,2041,79,49282,66617,115899,73.9781
Portugal,2041,80,47712,64297,112009,74.2056
Portugal,2041,81,43300,60042,103342,72.1162
Portugal,2041,82,41054,58241,99295,70.4899
Portugal,2041,83,38362,55244,93606,69.441
Portugal,2041,84,34826,51305,86131,67.8803
Portugal,2041,85,32284,49372,81656,65.3893
Portugal,2041,86,28694,44539,73233,64.4244
Portugal,2041,87,24966,40459,65425,61.7069
Portugal,2041,88,22498,37774,60272,59.5595
Portugal,2041,89,19731,33358,53089,59.1492
Portugal,2041,90,16411,28942,45353,56.7031
Portugal,2041,91,13233,24268,37501,54.5286
Portugal,2041,92,10788,21379,32167,50.4607
Portugal,2041,93,7677,16099,23776,47.6862
Portugal,2041,94,5864,13146,19010,44.6067
Portugal,2041,95,4519,10821,15340,41.7614
Portugal,2041,96,3040,7768,10808,39.1349
Portugal,2041,97,2050,5491,7541,37.3338
Portugal,2041,98,1291,3696,4987,34.9297
Portugal,2041,99,830,2505,3335,33.1337
Portugal,2041,100,1209,4293,5502,28.1621
Portugal,2042,0,38487,36222,74709,106.2531
Portugal,2042,1,38851,36578,75429,106.2141
Portugal,2042,2,39283,36989,76272,106.2018
Portugal,2042,3,39602,37296,76898,106.183
Portugal,2042,4,39730,37425,77155,106.159
Portugal,2042,5,40103,37782,77885,106.1431
Portugal,2042,6,40413,38076,78489,106.1377
Portugal,2042,7,40567,38232,78799,106.1074
Portugal,2042,8,40651,38317,78968,106.0913
Portugal,2042,9,40501,38187,78688,106.0597
Portugal,2042,10,40660,38346,79006,106.0345
Portugal,2042,11,40616,38329,78945,105.9668
Portugal,2042,12,40586,38313,78899,105.9327
Portugal,2042,13,40653,38402,79055,105.8617
Portugal,2042,14,40661,38441,79102,105.7751
Portugal,2042,15,40774,38581,79355,105.6841
Portugal,2042,16,40857,38706,79563,105.5573
Portugal,2042,17,41217,39100,80317,105.4143
Portugal,2042,18,41577,39505,81082,105.2449
Portugal,2042,19,41978,39960,81938,105.0501
Portugal,2042,20,42463,40506,82969,104.8314
Portugal,2042,21,44767,42652,87419,104.9587
Portugal,2042,22,46239,44075,90314,104.9098
Portugal,2042,23,46185,45030,91215,102.565
Portugal,2042,24,46284,44853,91137,103.1904
Portugal,2042,25,47247,45300,92547,104.298
Portugal,2042,26,46452,45050,91502,103.1121
Portugal,2042,27,45354,43256,88610,104.8502
Portugal,2042,28,45278,43952,89230,103.0169
Portugal,2042,29,49235,47002,96237,104.7509
Portugal,2042,30,52268,50142,102410,104.24
Portugal,2042,31,53631,52748,106379,101.674
Portugal,2042,32,52210,50815,103025,102.7453
Portugal,2042,33,54679,52560,107239,104.0316
Portugal,2042,34,53648,51928,105576,103.3123
Portugal,2042,35,54891,53572,108463,102.4621
Portugal,2042,36,57465,55172,112637,104.1561
Portugal,2042,37,56372,54839,111211,102.7955
Portugal,2042,38,57846,56051,113897,103.2024
Portugal,2042,39,58459,56450,114909,103.5589
Portugal,2042,40,58247,56314,114561,103.4325
Portugal,2042,41,62569,60855,123424,102.8165
Portugal,2042,42,60723,59745,120468,101.637
Portugal,2042,43,58761,57742,116503,101.7647
Portugal,2042,44,57694,57484,115178,100.3653
Portugal,2042,45,57225,55891,113116,102.3868
Portugal,2042,46,55972,55130,111102,101.5273
Portugal,2042,47,54885,54832,109717,100.0967
Portugal,2042,48,55987,57102,113089,98.0474
Portugal,2042,49,55738,57389,113127,97.1231
Portugal,2042,50,56532,57778,114310,97.8435
Portugal,2042,51,56016,57700,113716,97.0815
Portugal,2042,52,55248,57006,112254,96.9161
Portugal,2042,53,55480,57819,113299,95.9546
Portugal,2042,54,54898,57962,112860,94.7138
Portugal,2042,55,55118,59051,114169,93.3397
Portugal,2042,56,56124,60573,116697,92.6551
Portugal,2042,57,59346,64957,124303,91.362
Portugal,2042,58,60124,66438,126562,90.4964
Portugal,2042,59,62145,69930,132075,88.8674
Portugal,2042,60,61968,70716,132684,87.6294
Portugal,2042,61,64368,73717,138085,87.3177
Portugal,2042,62,63886,73426,137312,87.0073
Portugal,2042,63,64940,75761,140701,85.7169
Portugal,2042,64,70019,81421,151440,85.9962
Portugal,2042,65,70644,83338,153982,84.7681
Portugal,2042,66,70409,82906,153315,84.9263
Portugal,2042,67,68030,81997,150027,82.9664
Portugal,2042,68,65486,79219,144705,82.6645
Portugal,2042,69,64790,79145,143935,81.8624
Portugal,2042,70,63536,77810,141346,81.6553
Portugal,2042,71,61007,74673,135680,81.6989
Portugal,2042,72,58681,72411,131092,81.0388
Portugal,2042,73,57383,71451,128834,80.311
Portugal,2042,74,55870,71492,127362,78.1486
Portugal,2042,75,55581,71665,127246,77.5567
Portugal,2042,76,54913,71341,126254,76.9726
Portugal,2042,77,53914,71289,125203,75.6274
Portugal,2042,78,51212,68504,119716,74.7577
Portugal,2042,79,49551,67014,116565,73.9413
Portugal,2042,80,47610,65229,112839,72.989
Portugal,2042,81,45819,62691,108510,73.087
Portugal,2042,82,41310,58274,99584,70.8892
Portugal,2042,83,38901,56249,95150,69.1586
Portugal,2042,84,36054,53026,89080,67.9931
Portugal,2042,85,32405,48847,81252,66.3398
Portugal,2042,86,29661,46500,76161,63.7871
Portugal,2042,87,26002,41447,67449,62.7355
Portugal,2042,88,22283,37186,59469,59.9231
Portugal,2042,89,19675,34185,53860,57.5545
Portugal,2042,90,16897,29675,46572,56.9402
Portugal,2042,91,13777,25274,39051,54.5106
Portugal,2042,92,10902,20824,31726,52.3531
Portugal,2042,93,8733,18070,26803,48.3287
Portugal,2042,94,6056,13318,19374,45.4723
Portugal,2042,95,4476,10567,15043,42.3583
Portugal,2042,96,3330,8418,11748,39.5581
Portugal,2042,97,2166,5845,8011,37.0573
Portugal,2042,98,1411,3993,5404,35.3368
Portugal,2042,99,856,2592,3448,33.0247
Portugal,2042,100,1239,4323,5562,28.6607
Portugal,2043,0,38139,35895,74034,106.2516
Portugal,2043,1,38545,36283,74828,106.2343
Portugal,2043,2,38906,36633,75539,106.2048
Portugal,2043,3,39330,37037,76367,106.1911
Portugal,2043,4,39642,37336,76978,106.1763
Portugal,2043,5,39764,37459,77223,106.1534
Portugal,2043,6,40131,37811,77942,106.1358
Portugal,2043,7,40438,38101,78539,106.1337
Portugal,2043,8,40589,38253,78842,106.1067
Portugal,2043,9,40669,38334,79003,106.0912
Portugal,2043,10,40517,38203,78720,106.0571
Portugal,2043,11,40675,38362,79037,106.0294
Portugal,2043,12,40635,38349,78984,105.961
Portugal,2043,13,40612,38342,78954,105.9204
Portugal,2043,14,40692,38446,79138,105.842
Portugal,2043,15,40717,38505,79222,105.7447
Portugal,2043,16,40850,38668,79518,105.6429
Portugal,2043,17,40955,38819,79774,105.5025
Portugal,2043,18,41339,39238,80577,105.3545
Portugal,2043,19,41719,39665,81384,105.1784
Portugal,2043,20,42135,40137,82272,104.978
Portugal,2043,21,42633,40697,83330,104.7571
Portugal,2043,22,44946,42851,87797,104.889
Portugal,2043,23,46422,44276,90698,104.8469
Portugal,2043,24,46369,45231,91600,102.516
Portugal,2043,25,46466,45051,91517,103.1409
Portugal,2043,26,47423,45492,92915,104.2447
Portugal,2043,27,46621,45234,91855,103.0663
Portugal,2043,28,45513,43430,88943,104.7962
Portugal,2043,29,45428,44114,89542,102.9786
Portugal,2043,30,49374,47152,96526,104.7124
Portugal,2043,31,52396,50280,102676,104.2084
Portugal,2043,32,53749,52874,106623,101.6549
Portugal,2043,33,52318,50931,103249,102.7233
Portugal,2043,34,54773,52665,107438,104.0027
Portugal,2043,35,53731,52022,105753,103.2851
Portugal,2043,36,54965,53656,108621,102.4396
Portugal,2043,37,57528,55247,112775,104.1287
Portugal,2043,38,56425,54903,111328,102.7722
Portugal,2043,39,57886,56105,113991,103.1744
Portugal,2043,40,58485,56495,114980,103.5224
Portugal,2043,41,58259,56349,114608,103.3896
Portugal,2043,42,62565,60879,123444,102.7694
Portugal,2043,43,60707,59762,120469,101.5813
Portugal,2043,44,58734,57754,116488,101.6969
Portugal,2043,45,57655,57487,115142,100.2922
Portugal,2043,46,57170,55886,113056,102.2975
Portugal,2043,47,55901,55116,111017,101.4243
Portugal,2043,48,54800,54810,109610,99.9818
Portugal,2043,49,55882,57069,112951,97.9201
Portugal,2043,50,55616,57347,112963,96.9815
Portugal,2043,51,56383,57728,114111,97.6701
Portugal,2043,52,55845,57640,113485,96.8858
Portugal,2043,53,55060,56937,111997,96.7034
Portugal,2043,54,55273,57742,113015,95.7241
Portugal,2043,55,54677,57879,112556,94.4678
Portugal,2043,56,54874,58956,113830,93.0762
Portugal,2043,57,55851,60465,116316,92.3691
Portugal,2043,58,59031,64833,123864,91.0509
Portugal,2043,59,59774,66297,126071,90.1609
Portugal,2043,60,61749,69763,131512,88.5125
Portugal,2043,61,61537,70529,132066,87.2506
Portugal,2043,62,63891,73510,137401,86.9147
Portugal,2043,63,63396,73211,136607,86.5935
Portugal,2043,64,64421,75523,139944,85.2998
Portugal,2043,65,69439,81145,150584,85.574
Portugal,2043,66,70029,83035,153064,84.3367
Portugal,2043,67,69753,82579,152332,84.4682
Portugal,2043,68,67346,81642,148988,82.4894
Portugal,2043,69,64763,78829,143592,82.1563
Portugal,2043,70,64022,78714,142736,81.335
Portugal,2043,71,62721,77340,140061,81.0978
Portugal,2043,72,60154,74170,134324,81.1029
Portugal,2043,73,57792,71868,129660,80.4141
Portugal,2043,74,56425,70845,127270,79.6457
Portugal,2043,75,54850,70811,125661,77.4597
Portugal,2043,76,54457,70889,125346,76.8201
Portugal,2043,77,53663,70445,124108,76.1772
Portugal,2043,78,52536,70247,122783,74.7875
Portugal,2043,79,49725,67324,117049,73.8592
Portugal,2043,80,47900,65647,113547,72.966
Portugal,2043,81,45752,63632,109384,71.9009
Portugal,2043,82,43746,60880,104626,71.8561
Portugal,2043,83,39176,56317,95493,69.5634
Portugal,2043,84,36594,54030,90624,67.729
Portugal,2043,85,33582,50527,84109,66.4635
Portugal,2043,86,29805,46048,75853,64.7259
Portugal,2043,87,26909,43315,70224,62.124
Portugal,2043,88,23236,38136,61372,60.9293
Portugal,2043,89,19512,33691,53203,57.9146
Portugal,2043,90,16872,30447,47319,55.4143
Portugal,2043,91,14205,25947,40152,54.7462
Portugal,2043,92,11367,21717,33084,52.3415
Portugal,2043,93,8840,17626,26466,50.1532
Portugal,2043,94,6901,14970,21871,46.0989
Portugal,2043,95,4630,10721,15351,43.1863
Portugal,2043,96,3304,8233,11537,40.1312
Portugal,2043,97,2377,6343,8720,37.4744
Portugal,2043,98,1493,4256,5749,35.0799
Portugal,2043,99,936,2804,3740,33.3809
Portugal,2043,100,1273,4406,5679,28.8924
Portugal,2044,0,37595,35379,72974,106.2636
Portugal,2044,1,38198,35956,74154,106.2354
Portugal,2044,2,38599,36338,74937,106.2221
Portugal,2044,3,38953,36680,75633,106.1968
Portugal,2044,4,39370,37077,76447,106.1844
Portugal,2044,5,39675,37371,77046,106.1652
Portugal,2044,6,39793,37488,77281,106.1486
Portugal,2044,7,40156,37836,77992,106.1317
Portugal,2044,8,40459,38122,78581,106.1303
Portugal,2044,9,40606,38271,78877,106.1012
Portugal,2044,10,40685,38351,79036,106.0859
Portugal,2044,11,40532,38219,78751,106.052
Portugal,2044,12,40694,38383,79077,106.0209
Portugal,2044,13,40661,38378,79039,105.9487
Portugal,2044,14,40651,38385,79036,105.9033
Portugal,2044,15,40747,38509,79256,105.8116
Portugal,2044,16,40793,38592,79385,105.7033
Portugal,2044,17,40949,38781,79730,105.5904
Portugal,2044,18,41077,38957,80034,105.4419
Portugal,2044,19,41480,39398,80878,105.2845
Portugal,2044,20,41876,39842,81718,105.1052
Portugal,2044,21,42305,40328,82633,104.9023
Portugal,2044,22,42813,40896,83709,104.6875
Portugal,2044,23,45130,43054,88184,104.8219
Portugal,2044,24,46606,44478,91084,104.7844
Portugal,2044,25,46550,45429,91979,102.4676
Portugal,2044,26,46642,45243,91885,103.0922
Portugal,2044,27,47591,45676,93267,104.1926
Portugal,2044,28,46780,45407,92187,103.0238
Portugal,2044,29,45663,43592,89255,104.7509
Portugal,2044,30,45568,44264,89832,102.946
Portugal,2044,31,49502,47291,96793,104.6753
Portugal,2044,32,52514,50407,102921,104.18
Portugal,2044,33,53857,52990,106847,101.6362
Portugal,2044,34,52413,51036,103449,102.6981
Portugal,2044,35,54856,52759,107615,103.9747
Portugal,2044,36,53806,52107,105913,103.2606
Portugal,2044,37,55030,53732,108762,102.4157
Portugal,2044,38,57581,55312,112893,104.1022
Portugal,2044,39,56467,54958,111425,102.7457
Portugal,2044,40,57913,56151,114064,103.138
Portugal,2044,41,58498,56531,115029,103.4795
Portugal,2044,42,58260,56376,114636,103.3418
Portugal,2044,43,62548,60896,123444,102.7128
Portugal,2044,44,60679,59772,120451,101.5174
Portugal,2044,45,58694,57757,116451,101.6223
Portugal,2044,46,57600,57482,115082,100.2053
Portugal,2044,47,57098,55873,112971,102.1925
Portugal,2044,48,55816,55095,110911,101.3086
Portugal,2044,49,54701,54781,109482,99.854
Portugal,2044,50,55761,57029,112790,97.7766
Portugal,2044,51,55473,57299,112772,96.8132
Portugal,2044,52,56214,57669,113883,97.477
Portugal,2044,53,55657,57572,113229,96.6737
Portugal,2044,54,54858,56864,111722,96.4723
Portugal,2044,55,55053,57661,112714,95.477
Portugal,2044,56,54438,57788,112226,94.2029
Portugal,2044,57,54611,58854,113465,92.7906
Portugal,2044,58,55560,60353,115913,92.0584
Portugal,2044,59,58692,64699,123391,90.7155
Portugal,2044,60,59398,66143,125541,89.8024
Portugal,2044,61,61324,69582,130906,88.132
Portugal,2044,62,61088,70335,131423,86.8529
Portugal,2044,63,63408,73299,136707,86.506
Portugal,2044,64,62898,72986,135884,86.1782
Portugal,2044,65,63896,75273,139169,84.8857
Portugal,2044,66,68844,80856,149700,85.144
Portugal,2044,67,69387,82715,152102,83.8868
Portugal,2044,68,69062,82230,151292,83.9864
Portugal,2044,69,66614,81249,147863,81.9875
Portugal,2044,70,64007,78410,142417,81.6312
Portugal,2044,71,63214,78249,141463,80.7857
Portugal,2044,72,61858,76831,138689,80.5118
Portugal,2044,73,59258,73626,132884,80.4852
Portugal,2044,74,56843,71273,128116,79.7539
Portugal,2044,75,55412,70186,125598,78.9502
Portugal,2044,76,53759,70062,123821,76.7306
Portugal,2044,77,53238,70019,123257,76.0336
Portugal,2044,78,52314,69439,121753,75.3381
Portugal,2044,79,51034,69065,120099,73.8927
Portugal,2044,80,48093,65981,114074,72.8892
Portugal,2044,81,46056,64071,110127,71.8828
Portugal,2044,82,43709,61827,105536,70.6957
Portugal,2044,83,41515,58872,100387,70.5174
Portugal,2044,84,36881,54134,91015,68.1291
Portugal,2044,85,34114,51525,85639,66.2086
Portugal,2044,86,30915,47674,78589,64.8467
Portugal,2044,87,27065,42935,70000,63.0371
Portugal,2044,88,24072,39897,63969,60.3354
Portugal,2044,89,20369,34591,54960,58.8853
Portugal,2044,90,16751,30043,46794,55.7567
Portugal,2044,91,14201,26655,40856,53.2771
Portugal,2044,92,11733,22323,34056,52.5601
Portugal,2044,93,9228,18407,27635,50.1331
Portugal,2044,94,6994,14624,21618,47.8255
Portugal,2044,95,5283,12068,17351,43.7769
Portugal,2044,96,3422,8364,11786,40.9134
Portugal,2044,97,2360,6212,8572,37.991
Portugal,2044,98,1640,4625,6265,35.4595
Portugal,2044,99,992,2992,3984,33.1551
Portugal,2044,100,1344,4606,5950,29.1793
Portugal,2045,0,37132,34948,72080,106.2493
Portugal,2045,1,37654,35440,73094,106.2472
Portugal,2045,2,38252,36011,74263,106.2231
Portugal,2045,3,38647,36386,75033,106.2139
Portugal,2045,4,38993,36721,75714,106.1872
Portugal,2045,5,39404,37111,76515,106.1788
Portugal,2045,6,39704,37400,77104,106.1604
Portugal,2045,7,39817,37513,77330,106.1419
Portugal,2045,8,40178,37857,78035,106.131
Portugal,2045,9,40477,38140,78617,106.1274
Portugal,2045,10,40622,38287,78909,106.0987
Portugal,2045,11,40700,38367,79067,106.0807
Portugal,2045,12,40551,38239,78790,106.0462
Portugal,2045,13,40720,38412,79132,106.0085
Portugal,2045,14,40700,38422,79122,105.9289
Portugal,2045,15,40707,38449,79156,105.8727
Portugal,2045,16,40824,38597,79421,105.7699
Portugal,2045,17,40892,38705,79597,105.6504
Portugal,2045,18,41071,38920,79991,105.5267
Portugal,2045,19,41218,39117,80335,105.3711
Portugal,2045,20,41637,39576,81213,105.2077
Portugal,2045,21,42047,40033,82080,105.0308
Portugal,2045,22,42486,40528,83014,104.8312
Portugal,2045,23,42997,41098,84095,104.6207
Portugal,2045,24,45315,43255,88570,104.7625
Portugal,2045,25,46787,44677,91464,104.7228
Portugal,2045,26,46727,45622,92349,102.4221
Portugal,2045,27,46811,45427,92238,103.0466
Portugal,2045,28,47750,45850,93600,104.1439
Portugal,2045,29,46930,45569,92499,102.9867
Portugal,2045,30,45803,43743,89546,104.7093
Portugal,2045,31,45698,44404,90102,102.9142
Portugal,2045,32,49622,47419,97041,104.6458
Portugal,2045,33,52623,50524,103147,104.1545
Portugal,2045,34,53952,53095,107047,101.6141
Portugal,2045,35,52498,51130,103628,102.6755
Portugal,2045,36,54931,52844,107775,103.9494
Portugal,2045,37,53872,52183,106055,103.2367
Portugal,2045,38,55085,53797,108882,102.3942
Portugal,2045,39,57623,55367,112990,104.0746
Portugal,2045,40,56495,55005,111500,102.7088
Portugal,2045,41,57928,56187,114115,103.0986
Portugal,2045,42,58500,56558,115058,103.4336
Portugal,2045,43,58250,56396,114646,103.2875
Portugal,2045,44,62518,60906,123424,102.6467
Portugal,2045,45,60638,59775,120413,101.4437
Portugal,2045,46,58640,57752,116392,101.5376
Portugal,2045,47,57530,57468,114998,100.1079
Portugal,2045,48,57012,55852,112864,102.0769
Portugal,2045,49,55715,55066,110781,101.1786
Portugal,2045,50,54585,54745,109330,99.7077
Portugal,2045,51,55620,56982,112602,97.6098
Portugal,2045,52,55309,57242,112551,96.6231
Portugal,2045,53,56028,57602,113630,97.2675
Portugal,2045,54,55456,57498,112954,96.4486
Portugal,2045,55,54643,56786,111429,96.2262
Portugal,2045,56,54816,57573,112389,95.2113
Portugal,2045,57,54181,57691,111872,93.9159
Portugal,2045,58,54330,58747,113077,92.4813
Portugal,2045,59,55247,60231,115478,91.7252
Portugal,2045,60,58329,64550,122879,90.3625
Portugal,2045,61,58997,65974,124971,89.4246
Portugal,2045,62,60884,69393,130277,87.738
Portugal,2045,63,60635,70137,130772,86.4522
Portugal,2045,64,62919,73078,135997,86.0984
Portugal,2045,65,62395,72749,135144,85.7675
Portugal,2045,66,63360,75011,138371,84.4676
Portugal,2045,67,68225,80552,148777,84.6968
Portugal,2045,68,68713,82372,151085,83.4179
Portugal,2045,69,68325,81842,150167,83.484
Portugal,2045,70,65852,80826,146678,81.4738
Portugal,2045,71,63216,77957,141173,81.0909
Portugal,2045,72,62361,77745,140106,80.2122
Portugal,2045,73,60955,76280,137235,79.9095
Portugal,2045,74,58305,73029,131334,79.8381
Portugal,2045,75,55844,70624,126468,79.0723
Portugal,2045,76,54333,69460,123793,78.222
Portugal,2045,77,52580,69220,121800,75.9607
Portugal,2045,78,51926,69040,120966,75.2115
Portugal,2045,79,50848,68293,119141,74.4557
Portugal,2045,80,49390,67712,117102,72.9413
Portugal,2045,81,46273,64424,110697,71.8257
Portugal,2045,82,44032,62283,106315,70.6967
Portugal,2045,83,41514,59820,101334,69.3982
Portugal,2045,84,39118,56623,95741,69.085
Portugal,2045,85,34415,51659,86074,66.6196
Portugal,2045,86,31438,48652,80090,64.6181
Portugal,2045,87,28105,44489,72594,63.1729
Portugal,2045,88,24242,39584,63826,61.2419
Portugal,2045,89,21129,36224,57353,58.3287
Portugal,2045,90,17511,30877,48388,56.7121
Portugal,2045,91,14119,26330,40449,53.6232
Portugal,2045,92,11747,22958,34705,51.1673
Portugal,2045,93,9540,18945,28485,50.3563
Portugal,2045,94,7313,15291,22604,47.8255
Portugal,2045,95,5362,11804,17166,45.4253
Portugal,2045,96,3910,9427,13337,41.4766
Portugal,2045,97,2448,6319,8767,38.7403
Portugal,2045,98,1631,4535,6166,35.9647
Portugal,2045,99,1091,3255,4346,33.5177
Portugal,2045,100,1425,4863,6288,29.3029
Portugal,2046,0,36746,34582,71328,106.2576
Portugal,2046,1,37191,35010,72201,106.2296
Portugal,2046,2,37709,35496,73205,106.2345
Portugal,2046,3,38300,36059,74359,106.2148
Portugal,2046,4,38687,36426,75113,106.2071
Portugal,2046,5,39027,36755,75782,106.1815
Portugal,2046,6,39433,37141,76574,106.1711
Portugal,2046,7,39729,37425,77154,106.1563
Portugal,2046,8,39839,37534,77373,106.1411
Portugal,2046,9,40196,37875,78071,106.1281
Portugal,2046,10,40493,38156,78649,106.1249
Portugal,2046,11,40637,38303,78940,106.0935
Portugal,2046,12,40719,38387,79106,106.075
Portugal,2046,13,40577,38268,78845,106.0338
Portugal,2046,14,40759,38455,79214,105.9914
Portugal,2046,15,40756,38485,79241,105.901
Portugal,2046,16,40783,38537,79320,105.8282
Portugal,2046,17,40923,38710,79633,105.7169
Portugal,2046,18,41014,38844,79858,105.5864
Portugal,2046,19,41212,39080,80292,105.4555
Portugal,2046,20,41376,39295,80671,105.2958
Portugal,2046,21,41808,39767,81575,105.1324
Portugal,2046,22,42227,40233,82460,104.9561
Portugal,2046,23,42670,40730,83400,104.7631
Portugal,2046,24,43183,41301,84484,104.5568
Portugal,2046,25,45497,43454,88951,104.7015
Portugal,2046,26,46964,44869,91833,104.6691
Portugal,2046,27,46896,45806,92702,102.3796
Portugal,2046,28,46971,45601,92572,103.0043
Portugal,2046,29,47900,46012,93912,104.1033
Portugal,2046,30,47070,45720,92790,102.9528
Portugal,2046,31,45934,43882,89816,104.6762
Portugal,2046,32,45820,44532,90352,102.8923
Portugal,2046,33,49732,47536,97268,104.6197
Portugal,2046,34,52719,50629,103348,104.1281
Portugal,2046,35,54036,53189,107225,101.5924
Portugal,2046,36,52574,51216,103790,102.6515
Portugal,2046,37,54997,52920,107917,103.9248
Portugal,2046,38,53928,52249,106177,103.2135
Portugal,2046,39,55129,53853,108982,102.3694
Portugal,2046,40,57651,55414,113065,104.0369
Portugal,2046,41,56512,55042,111554,102.6707
Portugal,2046,42,57931,56215,114146,103.0526
Portugal,2046,43,58490,56579,115069,103.3776
Portugal,2046,44,58227,56410,114637,103.2211
Portugal,2046,45,62475,60909,123384,102.571
Portugal,2046,46,60581,59770,120351,101.3569
Portugal,2046,47,58569,57739,116308,101.4375
Portugal,2046,48,57444,57446,114890,99.9965
Portugal,2046,49,56910,55823,112733,101.9472
Portugal,2046,50,55599,55031,110630,101.0321
Portugal,2046,51,54449,54702,109151,99.5375
Portugal,2046,52,55458,56927,112385,97.4195
Portugal,2046,53,55129,57177,112306,96.4181
Portugal,2046,54,55828,57530,113358,97.0415
Portugal,2046,55,55241,57421,112662,96.2035
Portugal,2046,56,54411,56700,111111,95.963
Portugal,2046,57,54561,57477,112038,94.9267
Portugal,2046,58,53907,57588,111495,93.608
Portugal,2046,59,54029,58631,112660,92.1509
Portugal,2046,60,54910,60097,115007,91.369
Portugal,2046,61,57940,64389,122329,89.9843
Portugal,2046,62,58579,65799,124378,89.0272
Portugal,2046,63,60439,69202,129641,87.3371
Portugal,2046,64,60174,69930,130104,86.0489
Portugal,2046,65,62423,72846,135269,85.6917
Portugal,2046,66,61879,72502,134381,85.348
Portugal,2046,67,62800,74735,137535,84.0302
Portugal,2046,68,67573,80226,147799,84.2283
Portugal,2046,69,67992,81993,149985,82.9242
Portugal,2046,70,67557,81426,148983,82.9674
Portugal,2046,71,65050,80369,145419,80.9392
Portugal,2046,72,62377,77466,139843,80.5218
Portugal,2046,73,61466,77200,138666,79.6192
Portugal,2046,74,59992,75676,135668,79.2748
Portugal,2046,75,57298,72381,129679,79.1617
Portugal,2046,76,54776,69911,124687,78.351
Portugal,2046,77,53162,68645,121807,77.4448
Portugal,2046,78,51307,68275,119582,75.1476
Portugal,2046,79,50494,67927,118421,74.3357
Portugal,2046,80,49234,66985,116219,73.5
Portugal,2046,81,47547,66145,113692,71.883
Portugal,2046,82,44265,62659,106924,70.6443
Portugal,2046,83,41849,60298,102147,69.4036
Portugal,2046,84,39146,57574,96720,67.9925
Portugal,2046,85,36532,54076,90608,67.5568
Portugal,2046,86,31744,48821,80565,65.0212
Portugal,2046,87,28608,45445,74053,62.9508
Portugal,2046,88,25199,41060,66259,61.3712
Portugal,2046,89,21301,35980,57281,59.2023
Portugal,2046,90,18184,32373,50557,56.1703
Portugal,2046,91,14776,27094,41870,54.5361
Portugal,2046,92,11692,22708,34400,51.4885
Portugal,2046,93,9563,19511,29074,49.0134
Portugal,2046,94,7570,15761,23331,48.0299
Portugal,2046,95,5614,12361,17975,45.417
Portugal,2046,96,3974,9234,13208,43.0366
Portugal,2046,97,2801,7132,9933,39.2737
Portugal,2046,98,1693,4619,6312,36.653
Portugal,2046,99,1086,3196,4282,33.98
Portugal,2046,100,1537,5210,6747,29.501
Portugal,2047,0,36490,34337,70827,106.2702
Portugal,2047,1,36805,34644,71449,106.2377
Portugal,2047,2,37246,35065,72311,106.2199
Portugal,2047,3,37756,35544,73300,106.2233
Portugal,2047,4,38340,36099,74439,106.2079
Portugal,2047,5,38721,36461,75182,106.1984
Portugal,2047,6,39056,36784,75840,106.1766
Portugal,2047,7,39458,37166,76624,106.1669
Portugal,2047,8,39751,37446,77197,106.1555
Portugal,2047,9,39857,37552,77409,106.1382
Portugal,2047,10,40211,37891,78102,106.1228
Portugal,2047,11,40508,38173,78681,106.1169
Portugal,2047,12,40656,38324,78980,106.085
Portugal,2047,13,40745,38416,79161,106.0626
Portugal,2047,14,40616,38312,78928,106.0138
Portugal,2047,15,40814,38519,79333,105.9581
Portugal,2047,16,40832,38573,79405,105.8564
Portugal,2047,17,40882,38650,79532,105.7749
Portugal,2047,18,41045,38848,79893,105.6554
Portugal,2047,19,41156,39004,80160,105.5174
Portugal,2047,20,41370,39258,80628,105.3798
Portugal,2047,21,41547,39487,81034,105.2169
Portugal,2047,22,41989,39967,81956,105.0592
Portugal,2047,23,42412,40436,82848,104.8867
Portugal,2047,24,42856,40933,83789,104.6979
Portugal,2047,25,43366,41500,84866,104.4964
Portugal,2047,26,45674,43647,89321,104.6441
Portugal,2047,27,47133,45054,92187,104.6145
Portugal,2047,28,47056,45980,93036,102.3401
Portugal,2047,29,47121,45763,92884,102.9675
Portugal,2047,30,48040,46163,94203,104.066
Portugal,2047,31,47200,45860,93060,102.9219
Portugal,2047,32,46056,44011,90067,104.6466
Portugal,2047,33,45931,44650,90581,102.869
Portugal,2047,34,49830,47642,97472,104.5926
Portugal,2047,35,52804,50724,103528,104.1006
Portugal,2047,36,54112,53275,107387,101.5711
Portugal,2047,37,52642,51293,103935,102.63
Portugal,2047,38,55053,52987,108040,103.8991
Portugal,2047,39,53973,52306,106279,103.187
Portugal,2047,40,55160,53901,109061,102.3358
Portugal,2047,41,57667,55451,113118,103.9963
Portugal,2047,42,56517,55071,111588,102.6257
Portugal,2047,43,57923,56236,114159,102.9999
Portugal,2047,44,58468,56593,115061,103.3131
Portugal,2047,45,58191,56416,114607,103.1463
Portugal,2047,46,62417,60903,123320,102.4859
Portugal,2047,47,60508,59755,120263,101.2601
Portugal,2047,48,58482,57718,116200,101.3237
Portugal,2047,49,57343,57417,114760,99.8711
Portugal,2047,50,56793,55788,112581,101.8015
Portugal,2047,51,55463,54989,110452,100.862
Portugal,2047,52,54294,54651,108945,99.3468
Portugal,2047,53,55280,56864,112144,97.2144
Portugal,2047,54,54935,57107,112042,96.1966
Portugal,2047,55,55615,57454,113069,96.7992
Portugal,2047,56,55010,57336,112346,95.9432
Portugal,2047,57,54162,56608,110770,95.6791
Portugal,2047,58,54288,57377,111665,94.6163
Portugal,2047,59,53612,57477,111089,93.2756
Portugal,2047,60,53705,58503,112208,91.7987
Portugal,2047,61,54550,59950,114500,90.9925
Portugal,2047,62,57536,64222,121758,89.5892
Portugal,2047,63,58158,65622,123780,88.6258
Portugal,2047,64,59987,69003,128990,86.9339
Portugal,2047,65,59708,69713,129421,85.6483
Portugal,2047,66,61916,72603,134519,85.2802
Portugal,2047,67,61342,72242,133584,84.9118
Portugal,2047,68,62211,74440,136651,83.572
Portugal,2047,69,66877,79865,146742,83.7376
Portugal,2047,70,67241,81585,148826,82.4183
Portugal,2047,71,66750,80977,147727,82.4308
Portugal,2047,72,64204,79875,144079,80.3806
Portugal,2047,73,61499,76937,138436,79.9342
Portugal,2047,74,60513,76604,137117,78.9946
Portugal,2047,75,58975,75021,133996,78.6113
Portugal,2047,76,56223,71668,127891,78.4492
Portugal,2047,77,53617,69111,122728,77.581
Portugal,2047,78,51898,67731,119629,76.6237
Portugal,2047,79,49917,67200,117117,74.2812
Portugal,2047,80,48920,66654,115574,73.3939
Portugal,2047,81,47425,65466,112891,72.4422
Portugal,2047,82,45514,64368,109882,70.709
Portugal,2047,83,42102,60699,102801,69.3619
Portugal,2047,84,39494,58074,97568,68.0063
Portugal,2047,85,36592,55028,91620,66.4971
Portugal,2047,86,33729,51151,84880,65.9401
Portugal,2047,87,28916,45647,74563,63.347
Portugal,2047,88,25678,41987,67665,61.157
Portugal,2047,89,22168,37363,59531,59.3314
Portugal,2047,90,18355,32194,50549,57.0137
Portugal,2047,91,15364,28443,43807,54.0168
Portugal,2047,92,12252,23398,35650,52.3634
Portugal,2047,93,9532,19326,28858,49.3222
Portugal,2047,94,7599,16256,23855,46.7458
Portugal,2047,95,5820,12760,18580,45.6113
Portugal,2047,96,4166,9684,13850,43.0194
Portugal,2047,97,2850,6996,9846,40.7376
Portugal,2047,98,1940,5220,7160,37.1648
Portugal,2047,99,1129,3259,4388,34.6425
Portugal,2047,100,1602,5392,6994,29.7107
Portugal,2048,0,36062,33931,69993,106.2804
Portugal,2048,1,36550,34399,70949,106.2531
Portugal,2048,2,36860,34699,71559,106.2278
Portugal,2048,3,37294,35113,72407,106.2114
Portugal,2048,4,37797,35584,73381,106.2191
Portugal,2048,5,38374,36134,74508,106.1991
Portugal,2048,6,38750,36490,75240,106.1935
Portugal,2048,7,39081,36809,75890,106.1724
Portugal,2048,8,39480,37187,76667,106.1661
Portugal,2048,9,39769,37464,77233,106.1526
Portugal,2048,10,39873,37569,77442,106.1327
Portugal,2048,11,40227,37908,78135,106.1174
Portugal,2048,12,40527,38193,78720,106.1111
Portugal,2048,13,40683,38353,79036,106.0751
Portugal,2048,14,40784,38460,79244,106.0426
Portugal,2048,15,40672,38376,79048,105.9829
Portugal,2048,16,40891,38607,79498,105.916
Portugal,2048,17,40931,38686,79617,105.8031
Portugal,2048,18,41004,38788,79792,105.7131
Portugal,2048,19,41186,39008,80194,105.5835
Portugal,2048,20,41314,39182,80496,105.4413
Portugal,2048,21,41542,39449,80991,105.3056
Portugal,2048,22,41728,39686,81414,105.1454
Portugal,2048,23,42174,40170,82344,104.9888
Portugal,2048,24,42598,40638,83236,104.8231
Portugal,2048,25,43039,41132,84171,104.6363
Portugal,2048,26,43544,41693,85237,104.4396
Portugal,2048,27,45844,43831,89675,104.5926
Portugal,2048,28,47293,45227,92520,104.5681
Portugal,2048,29,47206,46142,93348,102.3059
Portugal,2048,30,47261,45914,93175,102.9337
Portugal,2048,31,48170,46302,94472,104.0344
Portugal,2048,32,47322,45988,93310,102.9008
Portugal,2048,33,46167,44129,90296,104.6183
Portugal,2048,34,46031,44757,90788,102.8465
Portugal,2048,35,49917,47738,97655,104.5645
Portugal,2048,36,52881,50811,103692,104.0739
Portugal,2048,37,54179,53352,107531,101.5501
Portugal,2048,38,52700,51360,104060,102.609
Portugal,2048,39,55098,53044,108142,103.8723
Portugal,2048,40,54006,52355,106361,103.1535
Portugal,2048,41,55179,53940,109119,102.297
Portugal,2048,42,57672,55481,113153,103.9491
Portugal,2048,43,56512,55094,111606,102.5738
Portugal,2048,44,57902,56252,114154,102.9332
Portugal,2048,45,58433,56600,115033,103.2385
Portugal,2048,46,58141,56415,114556,103.0595
Portugal,2048,47,62342,60889,123231,102.3863
Portugal,2048,48,60419,59733,120152,101.1484
Portugal,2048,49,58381,57690,116071,101.1978
Portugal,2048,50,57226,57381,114607,99.7299
Portugal,2048,51,56655,55747,112402,101.6288
Portugal,2048,52,55306,54939,110245,100.668
Portugal,2048,53,54123,54593,108716,99.1391
Portugal,2048,54,55089,56796,111885,96.9945
Portugal,2048,55,54729,57034,111763,95.9586
Portugal,2048,56,55385,57371,112756,96.5383
Portugal,2048,57,54761,57245,112006,95.6608
Portugal,2048,58,53895,56512,110407,95.3691
Portugal,2048,59,53995,57268,111263,94.2848
Portugal,2048,60,53295,57354,110649,92.9229
Portugal,2048,61,53357,58363,111720,91.4226
Portugal,2048,62,54175,59798,113973,90.5967
Portugal,2048,63,57129,64053,121182,89.1902
Portugal,2048,64,57730,65438,123168,88.2209
Portugal,2048,65,59530,68794,128324,86.5337
Portugal,2048,66,59231,69487,128718,85.2404
Portugal,2048,67,61388,72349,133737,84.8498
Portugal,2048,68,60777,71963,132740,84.4559
Portugal,2048,69,61581,74113,135694,83.0907
Portugal,2048,70,66151,79477,145628,83.2329
Portugal,2048,71,66451,81146,147597,81.8907
Portugal,2048,72,65895,80491,146386,81.8663
Portugal,2048,73,63315,79343,142658,79.7991
Portugal,2048,74,60562,76358,136920,79.3132
Portugal,2048,75,59506,75958,135464,78.3407
Portugal,2048,76,57888,74301,132189,77.9101
Portugal,2048,77,55053,70868,125921,77.6839
Portugal,2048,78,52364,68213,120577,76.7654
Portugal,2048,79,50515,66689,117204,75.7471
Portugal,2048,80,48384,65968,114352,73.3447
Portugal,2048,81,47147,65173,112320,72.3413
Portugal,2048,82,45424,63740,109164,71.2645
Portugal,2048,83,43318,62391,105709,69.4299
Portugal,2048,84,39762,58500,98262,67.9692
Portugal,2048,85,36947,55548,92495,66.5136
Portugal,2048,86,33813,52096,85909,64.9052
Portugal,2048,87,30753,47870,78623,64.2427
Portugal,2048,88,25981,42218,68199,61.5401
Portugal,2048,89,22613,38250,60863,59.119
Portugal,2048,90,19123,33471,52594,57.133
Portugal,2048,91,15526,28320,43846,54.8234
Portugal,2048,92,12754,24594,37348,51.8582
Portugal,2048,93,10001,19942,29943,50.1504
Portugal,2048,94,7585,16126,23711,47.0358
Portugal,2048,95,5850,13180,19030,44.3854
Portugal,2048,96,4324,10010,14334,43.1968
Portugal,2048,97,2992,7347,10339,40.7241
Portugal,2048,98,1976,5128,7104,38.5335
Portugal,2048,99,1295,3688,4983,35.1139
Portugal,2048,100,1669,5550,7219,30.0721
Portugal,2049,0,35766,33653,69419,106.2788
Portugal,2049,1,36122,33994,70116,106.2599
Portugal,2049,2,36605,34455,71060,106.24
Portugal,2049,3,36908,34747,71655,106.2192
Portugal,2049,4,37334,35154,72488,106.2013
Portugal,2049,5,37831,35619,73450,106.2102
Portugal,2049,6,38403,36163,74566,106.1942
Portugal,2049,7,38775,36515,75290,106.1892
Portugal,2049,8,39102,36831,75933,106.166
Portugal,2049,9,39498,37205,76703,106.1632
Portugal,2049,10,39784,37480,77264,106.1473
Portugal,2049,11,39888,37585,77473,106.1274
Portugal,2049,12,40246,37928,78174,106.1116
Portugal,2049,13,40554,38222,78776,106.1012
Portugal,2049,14,40722,38397,79119,106.0552
Portugal,2049,15,40840,38524,79364,106.0118
Portugal,2049,16,40749,38464,79213,105.9406
Portugal,2049,17,40990,38720,79710,105.8626
Portugal,2049,18,41053,38825,79878,105.7386
Portugal,2049,19,41146,38948,80094,105.6434
Portugal,2049,20,41345,39187,80532,105.5069
Portugal,2049,21,41485,39373,80858,105.3641
Portugal,2049,22,41723,39649,81372,105.2309
Portugal,2049,23,41914,39889,81803,105.0766
Portugal,2049,24,42360,40372,82732,104.9242
Portugal,2049,25,42781,40838,83619,104.7578
Portugal,2049,26,43217,41325,84542,104.5783
Portugal,2049,27,43714,41878,85592,104.3842
Portugal,2049,28,46005,44006,90011,104.5426
Portugal,2049,29,47444,45390,92834,104.5252
Portugal,2049,30,47347,46293,93640,102.2768
Portugal,2049,31,47392,46054,93446,102.9053
Portugal,2049,32,48292,46431,94723,104.0081
Portugal,2049,33,47433,46106,93539,102.8782
Portugal,2049,34,46267,44237,90504,104.5889
Portugal,2049,35,46120,44854,90974,102.8225
Portugal,2049,36,49995,47826,97821,104.5352
Portugal,2049,37,52950,50888,103838,104.052
Portugal,2049,38,54237,53419,107656,101.5313
Portugal,2049,39,52746,51418,104164,102.5828
Portugal,2049,40,55130,53093,108223,103.8367
Portugal,2049,41,54027,52395,106422,103.1148
Portugal,2049,42,55187,53971,109158,102.2531
Portugal,2049,43,57666,55504,113170,103.8952
Portugal,2049,44,56494,55110,111604,102.5113
Portugal,2049,45,57869,56260,114129,102.8599
Portugal,2049,46,58384,56600,114984,103.1519
Portugal,2049,47,58076,56405,114481,102.9625
Portugal,2049,48,62251,60867,123118,102.2738
Portugal,2049,49,60315,59704,120019,101.0234
Portugal,2049,50,58264,57655,115919,101.0563
Portugal,2049,51,57090,57339,114429,99.5657
Portugal,2049,52,56497,55697,112194,101.4363
Portugal,2049,53,55134,54882,110016,100.4592
Portugal,2049,54,53939,54531,108470,98.9144
Portugal,2049,55,54885,56725,111610,96.7563
Portugal,2049,56,54507,56953,111460,95.7052
Portugal,2049,57,55138,57282,112420,96.2571
Portugal,2049,58,54495,57149,111644,95.356
Portugal,2049,59,53608,56407,110015,95.0378
Portugal,2049,60,53680,57148,110828,93.9315
Portugal,2049,61,52955,57220,110175,92.5463
Portugal,2049,62,52996,58218,111214,91.0303
Portugal,2049,63,53799,59645,113444,90.1987
Portugal,2049,64,56716,63877,120593,88.7894
Portugal,2049,65,57298,65244,122542,87.8211
Portugal,2049,66,59063,68576,127639,86.1278
Portugal,2049,67,58735,69249,127984,84.8171
Portugal,2049,68,60833,72077,132910,84.4
Portugal,2049,69,60173,71655,131828,83.976
Portugal,2049,70,60925,73763,134688,82.5956
Portugal,2049,71,65388,79060,144448,82.7068
Portugal,2049,72,65617,80671,146288,81.339
Portugal,2049,73,65001,79968,144969,81.2838
Portugal,2049,74,62369,78761,141130,79.1877
Portugal,2049,75,59574,75729,135303,78.6674
Portugal,2049,76,58430,75247,133677,77.6509
Portugal,2049,77,56707,73491,130198,77.1618
Portugal,2049,78,53791,69969,123760,76.8783
Portugal,2049,79,50994,67188,118182,75.8975
Portugal,2049,80,48991,65494,114485,74.8023
Portugal,2049,81,46659,64532,111191,72.3037
Portugal,2049,82,45187,63488,108675,71.1741
Portugal,2049,83,43264,61820,105084,69.9838
Portugal,2049,84,40944,60171,101115,68.0461
Portugal,2049,85,37230,55998,93228,66.4845
Portugal,2049,86,34174,52634,86808,64.9276
Portugal,2049,87,30861,48801,79662,63.2385
Portugal,2049,88,27662,44321,71983,62.4129
Portugal,2049,89,22907,38503,61410,59.4941
Portugal,2049,90,19532,34307,53839,56.933
Portugal,2049,91,16196,29481,45677,54.9371
Portugal,2049,92,12905,24520,37425,52.6305
Portugal,2049,93,10426,20991,31417,49.6689
Portugal,2049,94,7969,16664,24633,47.8217
Portugal,2049,95,5847,13093,18940,44.6575
Portugal,2049,96,4352,10355,14707,42.028
Portugal,2049,97,3109,7605,10714,40.881
Portugal,2049,98,2077,5392,7469,38.52
Portugal,2049,99,1321,3627,4948,36.4213
Portugal,2049,100,1816,5940,7756,30.5724
Portugal,2050,0,35393,33299,68692,106.2885
Portugal,2050,1,35826,33715,69541,106.2613
Portugal,2050,2,36177,34050,70227,106.2467
Portugal,2050,3,36652,34502,71154,106.2315
Portugal,2050,4,36948,34788,71736,106.209
Portugal,2050,5,37368,35188,72556,106.1953
Portugal,2050,6,37860,35648,73508,106.2051
Portugal,2050,7,38428,36188,74616,106.1899
Portugal,2050,8,38796,36536,75332,106.1857
Portugal,2050,9,39121,36849,75970,106.1657
Portugal,2050,10,39513,37221,76734,106.1578
Portugal,2050,11,39800,37497,77297,106.1418
Portugal,2050,12,39907,37606,77513,106.1187
Portugal,2050,13,40272,37958,78230,106.0962
Portugal,2050,14,40592,38266,78858,106.0785
Portugal,2050,15,40778,38460,79238,106.027
Portugal,2050,16,40917,38612,79529,105.9696
Portugal,2050,17,40848,38577,79425,105.8869
Portugal,2050,18,41112,38858,79970,105.8006
Portugal,2050,19,41195,38985,80180,105.6688
Portugal,2050,20,41304,39127,80431,105.5639
Portugal,2050,21,41516,39378,80894,105.4294
Portugal,2050,22,41666,39573,81239,105.289
Portugal,2050,23,41908,39852,81760,105.1591
Portugal,2050,24,42100,40092,82192,105.0085
Portugal,2050,25,42544,40572,83116,104.8605
Portugal,2050,26,42960,41031,83991,104.7013
Portugal,2050,27,43388,41510,84898,104.5242
Portugal,2050,28,43876,42052,85928,104.3375
Portugal,2050,29,46156,44168,90324,104.501
Portugal,2050,30,47585,45541,93126,104.4883
Portugal,2050,31,47478,46433,93911,102.2506
Portugal,2050,32,47514,46183,93697,102.882
Portugal,2050,33,48403,46549,94952,103.9829
Portugal,2050,34,47533,46213,93746,102.8563
Portugal,2050,35,46356,44334,90690,104.5608
Portugal,2050,36,46201,44942,91143,102.8014
Portugal,2050,37,50066,47904,97970,104.5132
Portugal,2050,38,53008,50956,103964,104.027
Portugal,2050,39,54283,53476,107759,101.5091
Portugal,2050,40,52781,51468,104249,102.5511
Portugal,2050,41,55151,53133,108284,103.798
Portugal,2050,42,54037,52427,106464,103.0709
Portugal,2050,43,55185,53995,109180,102.2039
Portugal,2050,44,57648,55521,113169,103.831
Portugal,2050,45,56464,55120,111584,102.4383
Portugal,2050,46,57823,56260,114083,102.7782
Portugal,2050,47,58319,56591,114910,103.0535
Portugal,2050,48,57995,56388,114383,102.8499
Portugal,2050,49,62145,60838,122983,102.1483
Portugal,2050,50,60195,59668,119863,100.8832
Portugal,2050,51,58126,57613,115739,100.8904
Portugal,2050,52,56933,57288,114221,99.3803
Portugal,2050,53,56324,55640,111964,101.2293
Portugal,2050,54,54949,54820,109769,100.2353
Portugal,2050,55,53743,54464,108207,98.6762
Portugal,2050,56,54665,56647,111312,96.5011
Portugal,2050,57,54267,56867,111134,95.4279
Portugal,2050,58,54874,57188,112062,95.9537
Portugal,2050,59,54209,57045,111254,95.0285
Portugal,2050,60,53300,56291,109591,94.6865
Portugal,2050,61,53343,57017,110360,93.5563
Portugal,2050,62,52602,57081,109683,92.1533
Portugal,2050,63,52634,58073,110707,90.6342
Portugal,2050,64,53417,59485,112902,89.7991
Portugal,2050,65,56299,63693,119992,88.3912
Portugal,2050,66,56857,65043,121900,87.4145
Portugal,2050,67,58577,68347,126924,85.7053
Portugal,2050,68,58214,68995,127209,84.3742
Portugal,2050,69,60239,71775,132014,83.9276
Portugal,2050,70,59544,71324,130868,83.4838
Portugal,2050,71,60237,73385,133622,82.0835
Portugal,2050,72,64583,78609,143192,82.1573
Portugal,2050,73,64744,80160,144904,80.7685
Portugal,2050,74,64048,79396,143444,80.6691
Portugal,2050,75,61371,78129,139500,78.5509
Portugal,2050,76,58518,75039,133557,77.9834
Portugal,2050,77,57261,74447,131708,76.9151
Portugal,2050,78,55431,72582,128013,76.3702
Portugal,2050,79,52410,68943,121353,76.0193
Portugal,2050,80,49482,66011,115493,74.9602
Portugal,2050,81,47271,64098,111369,73.748
Portugal,2050,82,44748,62896,107644,71.146
Portugal,2050,83,43070,61611,104681,69.9063
Portugal,2050,84,40926,59659,100585,68.5999
Portugal,2050,85,38371,57642,96013,66.5678
Portugal,2050,86,34470,53105,87575,64.9091
Portugal,2050,87,31223,49351,80574,63.2672
Portugal,2050,88,27790,45230,73020,61.4415
Portugal,2050,89,24418,40465,64883,60.3435
Portugal,2050,90,19810,34574,54384,57.2974
Portugal,2050,91,16563,30254,46817,54.7465
Portugal,2050,92,13480,25557,39037,52.7448
Portugal,2050,93,10564,20958,31522,50.4056
Portugal,2050,94,8320,17567,25887,47.3615
Portugal,2050,95,6152,13550,19702,45.4022
Portugal,2050,96,4356,10302,14658,42.2831
Portugal,2050,97,3134,7879,11013,39.7766
Portugal,2050,98,2161,5590,7751,38.6583
Portugal,2050,99,1390,3820,5210,36.3874
Portugal,2050,100,1924,6155,8079,31.2591
Portugal,2051,0,34875,32818,67693,106.2679
Portugal,2051,1,35454,33362,68816,106.2706
Portugal,2051,2,35881,33771,69652,106.248
Portugal,2051,3,36225,34097,70322,106.241
Portugal,2051,4,36693,34543,71236,106.2241
Portugal,2051,5,36982,34823,71805,106.1999
Portugal,2051,6,37397,35218,72615,106.1872
Portugal,2051,7,37885,35673,73558,106.2008
Portugal,2051,8,38449,36209,74658,106.1863
Portugal,2051,9,38815,36554,75369,106.1854
Portugal,2051,10,39136,36865,76001,106.1603
Portugal,2051,11,39529,37238,76767,106.1523
Portugal,2051,12,39819,37517,77336,106.1359
Portugal,2051,13,39933,37635,77568,106.106
Portugal,2051,14,40311,38002,78313,106.076
Portugal,2051,15,40649,38330,78979,106.0501
Portugal,2051,16,40854,38548,79402,105.9822
Portugal,2051,17,41016,38725,79741,105.9161
Portugal,2051,18,40970,38715,79685,105.8246
Portugal,2051,19,41255,39019,80274,105.7305
Portugal,2051,20,41354,39163,80517,105.5946
Portugal,2051,21,41476,39318,80794,105.4886
Portugal,2051,22,41698,39578,81276,105.3565
Portugal,2051,23,41852,39776,81628,105.2192
Portugal,2051,24,42095,40055,82150,105.093
Portugal,2051,25,42284,40292,82576,104.9439
Portugal,2051,26,42723,40765,83488,104.8031
Portugal,2051,27,43131,41216,84347,104.6463
Portugal,2051,28,43550,41684,85234,104.4765
Portugal,2051,29,44028,42215,86243,104.2947
Portugal,2051,30,46297,44320,90617,104.4607
Portugal,2051,31,47716,45681,93397,104.4548
Portugal,2051,32,47600,46562,94162,102.2293
Portugal,2051,33,47626,46301,93927,102.8617
Portugal,2051,34,48503,46656,95159,103.9588
Portugal,2051,35,47622,46310,93932,102.8331
Portugal,2051,36,46437,44422,90859,104.536
Portugal,2051,37,46273,45022,91295,102.7786
Portugal,2051,38,50126,47973,98099,104.4879
Portugal,2051,39,53056,51015,104071,104.0008
Portugal,2051,40,54317,53526,107843,101.4778
Portugal,2051,41,52805,51510,104315,102.5141
Portugal,2051,42,55161,53165,108326,103.7543
Portugal,2051,43,54037,52453,106490,103.0198
Portugal,2051,44,55171,54013,109184,102.1439
Portugal,2051,45,57618,55530,113148,103.7601
Portugal,2051,46,56421,55121,111542,102.3584
Portugal,2051,47,57761,56252,114013,102.6826
Portugal,2051,48,58240,56574,114814,102.9448
Portugal,2051,49,57901,56364,114265,102.7269
Portugal,2051,50,62022,60802,122824,102.0065
Portugal,2051,51,60054,59626,119680,100.7178
Portugal,2051,52,57969,57564,115533,100.7036
Portugal,2051,53,56761,57231,113992,99.1788
Portugal,2051,54,56137,55579,111716,101.004
Portugal,2051,55,54752,54755,109507,99.9945
Portugal,2051,56,53531,54391,107922,98.4189
Portugal,2051,57,54429,56562,110991,96.2289
Portugal,2051,58,54012,56775,110787,95.1334
Portugal,2051,59,54590,57086,111676,95.6276
Portugal,2051,60,53902,56930,110832,94.6812
Portugal,2051,61,52970,56165,109135,94.3114
Portugal,2051,62,52993,56882,109875,93.163
Portugal,2051,63,52249,56941,109190,91.7599
Portugal,2051,64,52267,57920,110187,90.24
Portugal,2051,65,53032,59317,112349,89.4044
Portugal,2051,66,55874,63500,119374,87.9906
Portugal,2051,67,56398,64830,121228,86.9937
Portugal,2051,68,58067,68101,126168,85.266
Portugal,2051,69,57657,68713,126370,83.9099
Portugal,2051,70,59621,71451,131072,83.4432
Portugal,2051,71,58884,70967,129851,82.9738
Portugal,2051,72,59509,72975,132484,81.5471
Portugal,2051,73,63740,78122,141862,81.5903
Portugal,2051,74,63813,79599,143412,80.1681
Portugal,2051,75,63044,78773,141817,80.0325
Portugal,2051,76,60305,77432,137737,77.8812
Portugal,2051,77,57369,74258,131627,77.2563
Portugal,2051,78,55997,73546,129543,76.1387
Portugal,2051,79,54034,71539,125573,75.5308
Portugal,2051,80,50882,67759,118641,75.0926
Portugal,2051,81,47772,64629,112401,73.9173
Portugal,2051,82,45364,62500,107864,72.5824
Portugal,2051,83,42682,61067,103749,69.8937
Portugal,2051,84,40774,59491,100265,68.5381
Portugal,2051,85,38388,57188,95576,67.126
Portugal,2051,86,35559,54703,90262,65.0037
Portugal,2051,87,31524,49833,81357,63.2593
Portugal,2051,88,28147,45780,73927,61.4832
Portugal,2051,89,24560,41334,65894,59.4184
Portugal,2051,90,21143,36373,57516,58.1283
Portugal,2051,91,16820,30522,47342,55.1078
Portugal,2051,92,13803,26256,40059,52.5708
Portugal,2051,93,11050,21871,32921,50.5235
Portugal,2051,94,8442,17561,26003,48.0724
Portugal,2051,95,6432,14302,20734,44.9727
Portugal,2051,96,4590,10674,15264,43.0017
Portugal,2051,97,3141,7848,10989,40.0229
Portugal,2051,98,2181,5797,7978,37.6229
Portugal,2051,99,1448,3964,5412,36.5288
Portugal,2051,100,2031,6419,8450,31.6404
Portugal,2052,0,34542,32500,67042,106.2831
Portugal,2052,1,34935,32881,67816,106.2468
Portugal,2052,2,35509,33418,68927,106.2571
Portugal,2052,3,35929,33819,69748,106.2391
Portugal,2052,4,36265,34138,70403,106.2306
Portugal,2052,5,36727,34578,71305,106.2149
Portugal,2052,6,37012,34852,71864,106.1976
Portugal,2052,7,37423,35243,72666,106.1856
Portugal,2052,8,37906,35694,73600,106.1971
Portugal,2052,9,38468,36228,74696,106.1831
Portugal,2052,10,38830,36571,75401,106.177
Portugal,2052,11,39152,36882,76034,106.1548
Portugal,2052,12,39548,37258,76806,106.1463
Portugal,2052,13,39845,37547,77392,106.1203
Portugal,2052,14,39972,37679,77651,106.0856
Portugal,2052,15,40367,38065,78432,106.0476
Portugal,2052,16,40725,38418,79143,106.005
Portugal,2052,17,40954,38662,79616,105.9283
Portugal,2052,18,41138,38864,80002,105.8512
Portugal,2052,19,41113,38876,79989,105.7542
Portugal,2052,20,41413,39197,80610,105.6535
Portugal,2052,21,41526,39355,80881,105.5165
Portugal,2052,22,41658,39518,81176,105.4153
Portugal,2052,23,41883,39781,81664,105.2839
Portugal,2052,24,42039,39979,82018,105.1527
Portugal,2052,25,42279,40255,82534,105.0279
Portugal,2052,26,42463,40485,82948,104.8858
Portugal,2052,27,42894,40950,83844,104.7473
Portugal,2052,28,43293,41390,84683,104.5977
Portugal,2052,29,43702,41848,85550,104.4303
Portugal,2052,30,44170,42367,86537,104.2557
Portugal,2052,31,46429,44460,90889,104.4287
Portugal,2052,32,47838,45811,93649,104.4247
Portugal,2052,33,47713,46680,94393,102.2129
Portugal,2052,34,47726,46409,94135,102.8378
Portugal,2052,35,48592,46754,95346,103.9312
Portugal,2052,36,47703,46399,94102,102.8104
Portugal,2052,37,46510,44502,91012,104.5122
Portugal,2052,38,46336,45092,91428,102.7588
Portugal,2052,39,50176,48034,98210,104.4593
Portugal,2052,40,53091,51066,104157,103.9655
Portugal,2052,41,54340,53567,107907,101.4431
Portugal,2052,42,52817,51543,104360,102.4717
Portugal,2052,43,55160,53191,108351,103.7018
Portugal,2052,44,54025,52472,106497,102.9597
Portugal,2052,45,55145,54025,109170,102.0731
Portugal,2052,46,57575,55533,113108,103.6771
Portugal,2052,47,56363,55115,111478,102.2644
Portugal,2052,48,57684,56237,113921,102.573
Portugal,2052,49,58147,56551,114698,102.8222
Portugal,2052,50,57790,56334,114124,102.5846
Portugal,2052,51,61879,60759,122638,101.8433
Portugal,2052,52,59893,59575,119468,100.5338
Portugal,2052,53,57795,57507,115302,100.5008
Portugal,2052,54,56575,57169,113744,98.961
Portugal,2052,55,55938,55514,111452,100.7638
Portugal,2052,56,54539,54683,109222,99.7367
Portugal,2052,57,53303,54313,107616,98.1404
Portugal,2052,58,54176,56473,110649,95.9326
Portugal,2052,59,53736,56676,110412,94.8126
Portugal,2052,60,54285,56973,111258,95.282
Portugal,2052,61,53573,56805,110378,94.3104
Portugal,2052,62,52628,56034,108662,93.9215
Portugal,2052,63,52642,56745,109387,92.7694
Portugal,2052,64,51890,56795,108685,91.3637
Portugal,2052,65,51896,57761,109657,89.8461
Portugal,2052,66,52638,59143,111781,89.0012
Portugal,2052,67,55430,63299,118729,87.5685
Portugal,2052,68,55916,64604,120520,86.5519
Portugal,2052,69,57520,67830,125350,84.8002
Portugal,2052,70,57076,68412,125488,83.4298
Portugal,2052,71,58972,71104,130076,82.9377
Portugal,2052,72,58186,70582,128768,82.4374
Portugal,2052,73,58747,72537,131284,80.989
Portugal,2052,74,62841,77591,140432,80.9901
Portugal,2052,75,62831,78993,141824,79.54
Portugal,2052,76,61968,78091,140059,79.3536
Portugal,2052,77,59142,76650,135792,77.1585
Portugal,2052,78,56126,73385,129511,76.4816
Portugal,2052,79,54609,72518,127127,75.3041
Portugal,2052,80,52484,70342,122826,74.6126
Portugal,2052,81,49149,66373,115522,74.0497
Portugal,2052,82,45872,63054,108926,72.7503
Portugal,2052,83,43297,60722,104019,71.3036
Portugal,2052,84,40436,59010,99446,68.524
Portugal,2052,85,38276,57076,95352,67.0615
Portugal,2052,86,35605,54325,89930,65.5407
Portugal,2052,87,32551,51387,83938,63.3448
Portugal,2052,88,28447,46282,74729,61.4645
Portugal,2052,89,24902,41889,66791,59.4476
Portugal,2052,90,21289,37204,58493,57.2223
Portugal,2052,91,17972,32155,50127,55.8918
Portugal,2052,92,14033,26528,40561,52.8988
Portugal,2052,93,11329,22506,33835,50.3377
Portugal,2052,94,8842,18357,27199,48.1669
Portugal,2052,95,6535,14321,20856,45.6323
Portugal,2052,96,4804,11286,16090,42.566
Portugal,2052,97,3313,8145,11458,40.6753
Portugal,2052,98,2189,5784,7973,37.8458
Portugal,2052,99,1463,4117,5580,35.5356
Portugal,2052,100,2133,6685,8818,31.9073
Portugal,2053,0,34210,32185,66395,106.2918
Portugal,2053,1,34603,32563,67166,106.2648
Portugal,2053,2,34991,32937,67928,106.2361
Portugal,2053,3,35557,33466,69023,106.2481
Portugal,2053,4,35969,33860,69829,106.2286
Portugal,2053,5,36300,34173,70473,106.2242
Portugal,2053,6,36756,34607,71363,106.2097
Portugal,2053,7,37037,34877,71914,106.1932
Portugal,2053,8,37444,35264,72708,106.1819
Portugal,2053,9,37925,35713,73638,106.1938
Portugal,2053,10,38484,36244,74728,106.1803
Portugal,2053,11,38846,36587,75433,106.1743
Portugal,2053,12,39171,36902,76073,106.1487
Portugal,2053,13,39575,37288,76863,106.1333
Portugal,2053,14,39884,37591,77475,106.0999
Portugal,2053,15,40029,37743,77772,106.0568
Portugal,2053,16,40444,38153,78597,106.0048
Portugal,2053,17,40825,38531,79356,105.9536
Portugal,2053,18,41076,38800,79876,105.866
Portugal,2053,19,41281,39024,80305,105.7836
Portugal,2053,20,41271,39054,80325,105.6768
Portugal,2053,21,41585,39389,80974,105.5752
Portugal,2053,22,41708,39555,81263,105.4431
Portugal,2053,23,41844,39722,81566,105.3421
Portugal,2053,24,42070,39984,82054,105.2171
Portugal,2053,25,42223,40179,82402,105.0872
Portugal,2053,26,42458,40448,82906,104.9693
Portugal,2053,27,42634,40670,83304,104.8291
Portugal,2053,28,43056,41125,84181,104.6954
Portugal,2053,29,43446,41554,85000,104.5531
Portugal,2053,30,43845,42000,85845,104.3929
Portugal,2053,31,44303,42508,86811,104.2227
Portugal,2053,32,46552,44590,91142,104.4001
Portugal,2053,33,47951,45929,93880,104.4024
Portugal,2053,34,47813,46788,94601,102.1907
Portugal,2053,35,47816,46506,94322,102.8168
Portugal,2053,36,48672,46842,95514,103.9068
Portugal,2053,37,47775,46478,94253,102.7906
Portugal,2053,38,46573,44573,91146,104.487
Portugal,2053,39,46388,45153,91541,102.7351
Portugal,2053,40,50214,48086,98300,104.4254
Portugal,2053,41,53116,51108,104224,103.9289
Portugal,2053,42,54352,53600,107952,101.403
Portugal,2053,43,52820,51570,104390,102.4239
Portugal,2053,44,55148,53210,108358,103.6422
Portugal,2053,45,54002,52485,106487,102.8903
Portugal,2053,46,55106,54028,109134,101.9953
Portugal,2053,47,57515,55527,113042,103.5802
Portugal,2053,48,56291,55102,111393,102.1578
Portugal,2053,49,57593,56215,113808,102.4513
Portugal,2053,50,58038,56522,114560,102.6821
Portugal,2053,51,57661,56297,113958,102.4229
Portugal,2053,52,61715,60708,122423,101.6588
Portugal,2053,53,59716,59517,119233,100.3344
Portugal,2053,54,57609,57446,115055,100.2837
Portugal,2053,55,56377,57103,113480,98.7286
Portugal,2053,56,55723,55442,111165,100.5068
Portugal,2053,57,54310,54605,108915,99.4598
Portugal,2053,58,53059,54229,107288,97.8425
Portugal,2053,59,53904,56377,110281,95.6135
Portugal,2053,60,53440,56567,110007,94.472
Portugal,2053,61,53958,56850,110808,94.9129
Portugal,2053,62,53231,56675,109906,93.9232
Portugal,2053,63,52285,55903,108188,93.5281
Portugal,2053,64,52286,56603,108889,92.3732
Portugal,2053,65,51528,56643,108171,90.9698
Portugal,2053,66,51518,57595,109113,89.4487
Portugal,2053,67,52228,58960,111188,88.5821
Portugal,2053,68,54964,63083,118047,87.1297
Portugal,2053,69,55398,64353,119751,86.0846
Portugal,2053,70,56951,67539,124490,84.3231
Portugal,2053,71,56465,68086,124551,82.9319
Portugal,2053,72,58284,70726,129010,82.4082
Portugal,2053,73,57454,70168,127622,81.8806
Portugal,2053,74,57934,72055,129989,80.4025
Portugal,2053,75,61891,77014,138905,80.3633
Portugal,2053,76,61778,78324,140102,78.8749
Portugal,2053,77,60794,77319,138113,78.6275
Portugal,2053,78,57882,75767,133649,76.3947
Portugal,2053,79,54758,72381,127139,75.6525
Portugal,2053,80,53068,71328,124396,74.4
Portugal,2053,81,50722,68929,119651,73.5859
Portugal,2053,82,47221,64783,112004,72.891
Portugal,2053,83,43810,61289,105099,71.481
Portugal,2053,84,41048,58708,99756,69.9189
Portugal,2053,85,37988,56649,94637,67.0586
Portugal,2053,86,35532,54256,89788,65.4895
Portugal,2053,87,32622,51072,83694,63.8745
Portugal,2053,88,29402,47767,77169,61.553
Portugal,2053,89,25194,42387,67581,59.438
Portugal,2053,90,21609,37741,59350,57.256
Portugal,2053,91,18117,32924,51041,55.0267
Portugal,2053,92,15012,27978,42990,53.6564
Portugal,2053,93,11533,22766,34299,50.6589
Portugal,2053,94,9077,18913,27990,47.9934
Portugal,2053,95,6853,14989,21842,45.7202
Portugal,2053,96,4888,11315,16203,43.1993
Portugal,2053,97,3473,8622,12095,40.2807
Portugal,2053,98,2311,6010,8321,38.4526
Portugal,2053,99,1469,4112,5581,35.7247
Portugal,2053,100,2205,6963,9168,31.6674
Portugal,2054,0,33920,31913,65833,106.289
Portugal,2054,1,34271,32248,66519,106.2733
Portugal,2054,2,34659,32619,67278,106.254
Portugal,2054,3,35039,32985,68024,106.2271
Portugal,2054,4,35597,33507,69104,106.2375
Portugal,2054,5,36003,33894,69897,106.2223
Portugal,2054,6,36329,34202,70531,106.2189
Portugal,2054,7,36781,34632,71413,106.2052
Portugal,2054,8,37058,34898,71956,106.1895
Portugal,2054,9,37462,35282,72744,106.1788
Portugal,2054,10,37941,35729,73670,106.191
Portugal,2054,11,38499,36261,74760,106.1719
Portugal,2054,12,38865,36608,75473,106.1653
Portugal,2054,13,39198,36932,76130,106.1356
Portugal,2054,14,39614,37332,76946,106.1127
Portugal,2054,15,39941,37655,77596,106.0709
Portugal,2054,16,40106,37831,77937,106.0136
Portugal,2054,17,40544,38267,78811,105.9503
Portugal,2054,18,40947,38670,79617,105.8883
Portugal,2054,19,41219,38961,80180,105.7955
Portugal,2054,20,41439,39203,80642,105.7036
Portugal,2054,21,41444,39246,80690,105.6006
Portugal,2054,22,41767,39589,81356,105.5015
Portugal,2054,23,41894,39759,81653,105.3699
Portugal,2054,24,42031,39925,81956,105.2749
Portugal,2054,25,42254,40184,82438,105.1513
Portugal,2054,26,42402,40373,82775,105.0256
Portugal,2054,27,42630,40633,83263,104.9147
Portugal,2054,28,42797,40845,83642,104.779
Portugal,2054,29,43209,41289,84498,104.6501
Portugal,2054,30,43589,41706,85295,104.5149
Portugal,2054,31,43978,42141,86119,104.3592
Portugal,2054,32,44427,42638,87065,104.1958
Portugal,2054,33,46665,44709,91374,104.375
Portugal,2054,34,48051,46037,94088,104.3747
Portugal,2054,35,47903,46886,94789,102.1691
Portugal,2054,36,47897,46595,94492,102.7943
Portugal,2054,37,48744,46922,95666,103.883
Portugal,2054,38,47838,46549,94387,102.7691
Portugal,2054,39,46626,44635,91261,104.4606
Portugal,2054,40,46430,45207,91637,102.7053
Portugal,2054,41,50241,48130,98371,104.386
Portugal,2054,42,53129,51143,104272,103.8832
Portugal,2054,43,54354,53626,107980,101.3576
Portugal,2054,44,52811,51591,104402,102.3648
Portugal,2054,45,55124,53224,108348,103.5698
Portugal,2054,46,53966,52491,106457,102.81
Portugal,2054,47,55053,54025,109078,101.9028
Portugal,2054,48,57442,55514,112956,103.473
Portugal,2054,49,56205,55082,111287,102.0388
Portugal,2054,50,57488,56187,113675,102.3155
Portugal,2054,51,57910,56486,114396,102.521
Portugal,2054,52,57512,56254,113766,102.2363
Portugal,2054,53,61534,60651,122185,101.4559
Portugal,2054,54,59525,59455,118980,100.1177
Portugal,2054,55,57410,57381,114791,100.0505
Portugal,2054,56,56164,57030,113194,98.4815
Portugal,2054,57,55492,55365,110857,100.2294
Portugal,2054,58,54065,54524,108589,99.1582
Portugal,2054,59,52797,54139,106936,97.5212
Portugal,2054,60,53611,56270,109881,95.2746
Portugal,2054,61,53123,56447,109570,94.1113
Portugal,2054,62,53619,56723,110342,94.5278
Portugal,2054,63,52890,56545,109435,93.5361
Portugal,2054,64,51937,55767,107704,93.1321
Portugal,2054,65,51928,56455,108383,91.9812
Portugal,2054,66,51159,56485,107644,90.5709
Portugal,2054,67,51124,57422,108546,89.0321
Portugal,2054,68,51798,58765,110563,88.1443
Portugal,2054,69,54465,62844,117309,86.667
Portugal,2054,70,54861,64085,118946,85.6066
Portugal,2054,71,56354,67227,123581,83.8264
Portugal,2054,72,55820,67735,123555,82.4094
Portugal,2054,73,57566,70323,127889,81.8594
Portugal,2054,74,56674,69716,126390,81.2927
Portugal,2054,75,57076,71535,128611,79.7875
Portugal,2054,76,60875,76381,137256,79.6991
Portugal,2054,77,60630,77573,138203,78.1586
Portugal,2054,78,59524,76455,135979,77.8549
Portugal,2054,79,56498,74760,131258,75.5725
Portugal,2054,80,53240,71224,124464,74.7501
Portugal,2054,81,51316,69930,121246,73.382
Portugal,2054,82,48763,67315,116078,72.44
Portugal,2054,83,45130,63010,108140,71.6236
Portugal,2054,84,41565,59300,100865,70.0927
Portugal,2054,85,38596,56406,95002,68.4253
Portugal,2054,86,35298,53901,89199,65.4867
Portugal,2054,87,32587,51060,83647,63.821
Portugal,2054,88,29500,47529,77029,62.0674
Portugal,2054,89,26070,43802,69872,59.5178
Portugal,2054,90,21890,38241,60131,57.2422
Portugal,2054,91,18412,33446,51858,55.0499
Portugal,2054,92,15153,28689,43842,52.8182
Portugal,2054,93,12355,24050,36405,51.3721
Portugal,2054,94,9254,19164,28418,48.2885
Portugal,2054,95,7046,15469,22515,45.5492
Portugal,2054,96,5133,11862,16995,43.2726
Portugal,2054,97,3538,8658,12196,40.8639
Portugal,2054,98,2426,6372,8798,38.0728
Portugal,2054,99,1554,4279,5833,36.3169
Portugal,2054,100,2253,7139,9392,31.559
Portugal,2055,0,33616,31627,65243,106.2889
Portugal,2055,1,33981,31976,65957,106.2703
Portugal,2055,2,34326,32305,66631,106.256
Portugal,2055,3,34707,32668,67375,106.2416
Portugal,2055,4,35079,33026,68105,106.2163
Portugal,2055,5,35632,33541,69173,106.2342
Portugal,2055,6,36033,33924,69957,106.2168
Portugal,2055,7,36354,34228,70582,106.2113
Portugal,2055,8,36803,34654,71457,106.2013
Portugal,2055,9,37077,34917,71994,106.1861
Portugal,2055,10,37478,35299,72777,106.173
Portugal,2055,11,37956,35746,73702,106.1825
Portugal,2055,12,38518,36281,74799,106.1658
Portugal,2055,13,38892,36637,75529,106.155
Portugal,2055,14,39237,36976,76213,106.1148
Portugal,2055,15,39670,37396,77066,106.0809
Portugal,2055,16,40018,37742,77760,106.0304
Portugal,2055,17,40205,37944,78149,105.9588
Portugal,2055,18,40666,38405,79071,105.8873
Portugal,2055,19,41090,38831,79921,105.8175
Portugal,2055,20,41378,39139,80517,105.7206
Portugal,2055,21,41612,39395,81007,105.6276
Portugal,2055,22,41626,39447,81073,105.5239
Portugal,2055,23,41953,39793,81746,105.4281
Portugal,2055,24,42080,39962,82042,105.3
Portugal,2055,25,42215,40125,82340,105.2087
Portugal,2055,26,42434,40378,82812,105.0919
Portugal,2055,27,42574,40558,83132,104.9707
Portugal,2055,28,42792,40808,83600,104.8618
Portugal,2055,29,42950,41009,83959,104.7331
Portugal,2055,30,43353,41441,84794,104.6138
Portugal,2055,31,43722,41847,85569,104.4806
Portugal,2055,32,44102,42271,86373,104.3316
Portugal,2055,33,44541,42757,87298,104.1724
Portugal,2055,34,46766,44817,91583,104.3488
Portugal,2055,35,48141,46135,94276,104.3481
Portugal,2055,36,47984,46974,94958,102.1501
Portugal,2055,37,47970,46675,94645,102.7745
Portugal,2055,38,48807,46992,95799,103.8624
Portugal,2055,39,47890,46610,94500,102.7462
Portugal,2055,40,46668,44688,91356,104.4307
Portugal,2055,41,46461,45252,91713,102.6717
Portugal,2055,42,50259,48166,98425,104.3454
Portugal,2055,43,53133,51171,104304,103.8342
Portugal,2055,44,54344,53647,107991,101.2992
Portugal,2055,45,52792,51606,104398,102.2982
Portugal,2055,46,55088,53229,108317,103.4925
Portugal,2055,47,53916,52489,106405,102.7187
Portugal,2055,48,54986,54014,109000,101.7995
Portugal,2055,49,57356,55495,112851,103.3535
Portugal,2055,50,56104,55056,111160,101.9035
Portugal,2055,51,57363,56153,113516,102.1548
Portugal,2055,52,57763,56443,114206,102.3386
Portugal,2055,53,57348,56203,113551,102.0373
Portugal,2055,54,61340,60588,121928,101.2412
Portugal,2055,55,59322,59389,118711,99.8872
Portugal,2055,56,57196,57310,114506,99.8011
Portugal,2055,57,55935,56952,112887,98.2143
Portugal,2055,58,55245,55284,110529,99.9295
Portugal,2055,59,53801,54435,108236,98.8353
Portugal,2055,60,52515,54039,106554,97.1798
Portugal,2055,61,53297,56153,109450,94.9139
Portugal,2055,62,52795,56324,109119,93.7345
Portugal,2055,63,53281,56596,109877,94.1427
Portugal,2055,64,52544,56410,108954,93.1466
Portugal,2055,65,51588,55624,107212,92.7441
Portugal,2055,66,51563,56301,107864,91.5845
Portugal,2055,67,50775,56318,107093,90.1577
Portugal,2055,68,50711,57236,107947,88.5998
Portugal,2055,69,51337,58548,109885,87.6836
Portugal,2055,70,53947,62588,116535,86.1938
Portugal,2055,71,54297,63795,118092,85.1117
Portugal,2055,72,55722,66888,122610,83.3064
Portugal,2055,73,55146,67358,122504,81.87
Portugal,2055,74,56800,69880,126680,81.2822
Portugal,2055,75,55852,69224,125076,80.683
Portugal,2055,76,56158,70961,127119,79.1392
Portugal,2055,77,59766,75664,135430,78.9887
Portugal,2055,78,59388,76724,136112,77.4047
Portugal,2055,79,58127,75459,133586,77.0312
Portugal,2055,80,54959,73589,128548,74.6837
Portugal,2055,81,51510,69853,121363,73.7406
Portugal,2055,82,49363,68320,117683,72.2526
Portugal,2055,83,46635,65503,112138,71.1952
Portugal,2055,84,42851,60997,103848,70.251
Portugal,2055,85,39116,57010,96126,68.6125
Portugal,2055,86,35896,53707,89603,66.8367
Portugal,2055,87,32405,50765,83170,63.8333
Portugal,2055,88,29500,47559,77059,62.0282
Portugal,2055,89,26186,43623,69809,60.028
Portugal,2055,90,22678,39556,62234,57.3314
Portugal,2055,91,18674,33924,52598,55.0466
Portugal,2055,92,15419,29176,44595,52.8482
Portugal,2055,93,12488,24690,37178,50.5792
Portugal,2055,94,9927,20269,30196,48.9763
Portugal,2055,95,7193,15694,22887,45.8328
Portugal,2055,96,5284,12257,17541,43.1101
Portugal,2055,97,3720,9088,12808,40.9331
Portugal,2055,98,2474,6406,8880,38.62
Portugal,2055,99,1632,4542,6174,35.9313
Portugal,2055,100,2336,7364,9700,31.7219
Portugal,2056,0,33408,31433,64841,106.2832
Portugal,2056,1,33677,31691,65368,106.2668
Portugal,2056,2,34037,32033,66070,106.256
Portugal,2056,3,34374,32353,66727,106.2467
Portugal,2056,4,34747,32708,67455,106.2339
Portugal,2056,5,35113,33061,68174,106.2067
Portugal,2056,6,35661,33571,69232,106.2256
Portugal,2056,7,36058,33949,70007,106.2123
Portugal,2056,8,36376,34249,70625,106.2104
Portugal,2056,9,36821,34672,71493,106.1981
Portugal,2056,10,37093,34933,72026,106.1833
Portugal,2056,11,37494,35315,72809,106.1702
Portugal,2056,12,37975,35767,73742,106.1733
Portugal,2056,13,38545,36311,74856,106.1524
Portugal,2056,14,38931,36681,75612,106.134
Portugal,2056,15,39293,37040,76333,106.0826
Portugal,2056,16,39747,37484,77231,106.0372
Portugal,2056,17,40118,37856,77974,105.9753
Portugal,2056,18,40328,38083,78411,105.895
Portugal,2056,19,40809,38566,79375,105.816
Portugal,2056,20,41249,39009,80258,105.7423
Portugal,2056,21,41550,39331,80881,105.6419
Portugal,2056,22,41794,39595,81389,105.5537
Portugal,2056,23,41812,39650,81462,105.4527
Portugal,2056,24,42140,39996,82136,105.3605
Portugal,2056,25,42265,40162,82427,105.2363
Portugal,2056,26,42395,40319,82714,105.1489
Portugal,2056,27,42606,40563,83169,105.0366
Portugal,2056,28,42737,40733,83470,104.9198
Portugal,2056,29,42946,40972,83918,104.8179
Portugal,2056,30,43094,41161,84255,104.6962
Portugal,2056,31,43486,41582,85068,104.5789
Portugal,2056,32,43847,41978,85825,104.4523
Portugal,2056,33,44217,42391,86608,104.3075
Portugal,2056,34,44643,42866,87509,104.1455
Portugal,2056,35,46857,44916,91773,104.3214
Portugal,2056,36,48223,46224,94447,104.3246
Portugal,2056,37,48057,47054,95111,102.1316
Portugal,2056,38,48033,46745,94778,102.7554
Portugal,2056,39,48859,47054,95913,103.836
Portugal,2056,40,47932,46664,94596,102.7173
Portugal,2056,41,46699,44734,91433,104.3926
Portugal,2056,42,46482,45290,91772,102.6319
Portugal,2056,43,50266,48196,98462,104.295
Portugal,2056,44,53126,51193,104319,103.7759
Portugal,2056,45,54324,53661,107985,101.2355
Portugal,2056,46,52760,51613,104373,102.2223
Portugal,2056,47,55037,53227,108264,103.4005
Portugal,2056,48,53853,52480,106333,102.6162
Portugal,2056,49,54906,53997,108903,101.6834
Portugal,2056,50,57255,55470,112725,103.218
Portugal,2056,51,55986,55024,111010,101.7483
Portugal,2056,52,57220,56111,113331,101.9764
Portugal,2056,53,57600,56393,113993,102.1403
Portugal,2056,54,57172,56147,113319,101.8256
Portugal,2056,55,61133,60522,121655,101.0096
Portugal,2056,56,59104,59316,118420,99.6426
Portugal,2056,57,56965,57233,114198,99.5317
Portugal,2056,58,55689,56870,112559,97.9233
Portugal,2056,59,54979,55196,110175,99.6069
Portugal,2056,60,53517,54336,107853,98.4927
Portugal,2056,61,52212,53930,106142,96.8144
Portugal,2056,62,52973,56033,109006,94.5389
Portugal,2056,63,52467,56200,108667,93.3577
Portugal,2056,64,52938,56464,109402,93.7553
Portugal,2056,65,52196,56269,108465,92.7616
Portugal,2056,66,51231,55476,106707,92.348
Portugal,2056,67,51183,56140,107323,91.1703
Portugal,2056,68,50373,56141,106514,89.7259
Portugal,2056,69,50268,57030,107298,88.1431
Portugal,2056,70,50857,58316,109173,87.2093
Portugal,2056,71,53403,62313,115716,85.7012
Portugal,2056,72,53699,63482,117181,84.5893
Portugal,2056,73,55062,66525,121587,82.7689
Portugal,2056,74,54426,66945,121371,81.2996
Portugal,2056,75,55992,69400,125392,80.6801
Portugal,2056,76,54970,68683,123653,80.0344
Portugal,2056,77,55154,70313,125467,78.4407
Portugal,2056,78,58564,74858,133422,78.2335
Portugal,2056,79,58019,75750,133769,76.5927
Portugal,2056,80,56569,74304,130873,76.1318
Portugal,2056,81,53200,72202,125402,73.6822
Portugal,2056,82,49578,68278,117856,72.612
Portugal,2056,83,47239,66518,113757,71.0169
Portugal,2056,84,44310,63450,107760,69.8345
Portugal,2056,85,40356,58683,99039,68.7695
Portugal,2056,86,36410,54325,90735,67.0225
Portugal,2056,87,32983,50628,83611,65.1477
Portugal,2056,88,29363,47331,76694,62.0376
Portugal,2056,89,26214,43697,69911,59.9904
Portugal,2056,90,22804,39440,62244,57.8195
Portugal,2056,91,19369,35133,54502,55.1305
Portugal,2056,92,15657,29631,45288,52.8399
Portugal,2056,93,12724,25144,37868,50.6045
Portugal,2056,94,10048,20839,30887,48.2173
Portugal,2056,95,7727,16624,24351,46.481
Portugal,2056,96,5402,12453,17855,43.3791
Portugal,2056,97,3834,9404,13238,40.7699
Portugal,2056,98,2605,6733,9338,38.69
Portugal,2056,99,1667,4572,6239,36.4611
Portugal,2056,100,2437,7690,10127,31.6905
Portugal,2057,0,33229,31263,64492,106.2886
Portugal,2057,1,33469,31497,64966,106.2609
Portugal,2057,2,33733,31747,65480,106.2557
Portugal,2057,3,34085,32081,66166,106.2467
Portugal,2057,4,34415,32394,66809,106.2388
Portugal,2057,5,34782,32743,67525,106.2273
Portugal,2057,6,35143,33091,68234,106.2011
Portugal,2057,7,35686,33596,69282,106.221
Portugal,2057,8,36079,33970,70049,106.2084
Portugal,2057,9,36394,34267,70661,106.2071
Portugal,2057,10,36837,34688,71525,106.1952
Portugal,2057,11,37108,34950,72058,106.1745
Portugal,2057,12,37513,35336,72849,106.1609
Portugal,2057,13,38002,35796,73798,106.1627
Portugal,2057,14,38584,36355,74939,106.1312
Portugal,2057,15,38987,36746,75733,106.0986
Portugal,2057,16,39370,37128,76498,106.0386
Portugal,2057,17,39847,37597,77444,105.9845
Portugal,2057,18,40240,37995,78235,105.9087
Portugal,2057,19,40471,38244,78715,105.8231
Portugal,2057,20,40968,38745,79713,105.7375
Portugal,2057,21,41422,39201,80623,105.6657
Portugal,2057,22,41732,39532,81264,105.5651
Portugal,2057,23,41980,39799,81779,105.48
Portugal,2057,24,41999,39853,81852,105.3848
Portugal,2057,25,42325,40196,82521,105.2965
Portugal,2057,26,42445,40356,82801,105.1764
Portugal,2057,27,42567,40504,83071,105.0933
Portugal,2057,28,42769,40738,83507,104.9855
Portugal,2057,29,42891,40897,83788,104.8757
Portugal,2057,30,43090,41125,84215,104.7781
Portugal,2057,31,43228,41303,84531,104.6607
Portugal,2057,32,43611,41713,85324,104.5501
Portugal,2057,33,43961,42098,86059,104.4254
Portugal,2057,34,44319,42500,86819,104.28
Portugal,2057,35,44735,42965,87700,104.1196
Portugal,2057,36,46940,45005,91945,104.2995
Portugal,2057,37,48296,46305,94601,104.2998
Portugal,2057,38,48121,47125,95246,102.1135
Portugal,2057,39,48086,46807,94893,102.7325
Portugal,2057,40,48901,47107,96008,103.8084
Portugal,2057,41,47962,46709,94671,102.6826
Portugal,2057,42,46720,44773,91493,104.3486
Portugal,2057,43,46494,45322,91816,102.5859
Portugal,2057,44,50263,48220,98483,104.2368
Portugal,2057,45,53108,51209,104317,103.7083
Portugal,2057,46,54291,53667,107958,101.1627
Portugal,2057,47,52714,51613,104327,102.1332
Portugal,2057,48,54973,53219,108192,103.2958
Portugal,2057,49,53777,52465,106242,102.5007
Portugal,2057,50,54812,53974,108786,101.5526
Portugal,2057,51,57135,55438,112573,103.0611
Portugal,2057,52,55849,54985,110834,101.5713
Portugal,2057,53,57062,56063,113125,101.7819
Portugal,2057,54,57426,56339,113765,101.9294
Portugal,2057,55,56983,56089,113072,101.5939
Portugal,2057,56,60911,60449,121360,100.7643
Portugal,2057,57,58868,59238,118106,99.3754
Portugal,2057,58,56718,57153,113871,99.2389
Portugal,2057,59,55424,56781,112205,97.6101
Portugal,2057,60,54693,55097,109790,99.2667
Portugal,2057,61,53212,54228,107440,98.1264
Portugal,2057,62,51899,53817,105716,96.4361
Portugal,2057,63,52649,55913,108562,94.1624
Portugal,2057,64,52135,56072,108207,92.9787
Portugal,2057,65,52593,56326,108919,93.3725
Portugal,2057,66,51842,56123,107965,92.3721
Portugal,2057,67,50860,55321,106181,91.9362
Portugal,2057,68,50783,55967,106750,90.7374
Portugal,2057,69,49940,55944,105884,89.2678
Portugal,2057,70,49807,56810,106617,87.6729
Portugal,2057,71,50353,58066,108419,86.7168
Portugal,2057,72,52825,62015,114840,85.181
Portugal,2057,73,53075,63147,116222,84.0499
Portugal,2057,74,54356,66128,120484,82.1982
Portugal,2057,75,53666,66498,120164,80.7032
Portugal,2057,76,55124,68872,123996,80.0383
Portugal,2057,77,54006,68072,122078,79.3366
Portugal,2057,78,54064,69582,123646,77.6983
Portugal,2057,79,57236,73930,131166,77.4192
Portugal,2057,80,56489,74617,131106,75.7053
Portugal,2057,81,54785,72934,127719,75.1159
Portugal,2057,82,51232,70606,121838,72.5604
Portugal,2057,83,47473,66511,113984,71.3762
Portugal,2057,84,44914,64471,109385,69.6654
Portugal,2057,85,41762,61085,102847,68.367
Portugal,2057,86,37595,55963,93558,67.1783
Portugal,2057,87,33485,51256,84741,65.3289
Portugal,2057,88,29916,47249,77165,63.3156
Portugal,2057,89,26119,43534,69653,59.9968
Portugal,2057,90,22853,39552,62405,57.7796
Portugal,2057,91,19498,35072,54570,55.5942
Portugal,2057,92,16258,30725,46983,52.9146
Portugal,2057,93,12936,25571,38507,50.5886
Portugal,2057,94,10250,21253,31503,48.2285
Portugal,2057,95,7830,17116,24946,45.7467
Portugal,2057,96,5810,13210,19020,43.9818
Portugal,2057,97,3924,9568,13492,41.0117
Portugal,2057,98,2688,6977,9665,38.5266
Portugal,2057,99,1757,4812,6569,36.5129
Portugal,2057,100,2523,7927,10450,31.8279
Portugal,2058,0,33008,31051,64059,106.3025
Portugal,2058,1,33291,31327,64618,106.2694
Portugal,2058,2,33525,31553,65078,106.2498
Portugal,2058,3,33781,31795,65576,106.2463
Portugal,2058,4,34126,32122,66248,106.2387
Portugal,2058,5,34449,32428,66877,106.2323
Portugal,2058,6,34811,32773,67584,106.2185
Portugal,2058,7,35168,33116,68284,106.1964
Portugal,2058,8,35708,33618,69326,106.2169
Portugal,2058,9,36098,33989,70087,106.2049
Portugal,2058,10,36410,34284,70694,106.2011
Portugal,2058,11,36853,34705,71558,106.1893
Portugal,2058,12,37128,34971,72099,106.168
Portugal,2058,13,37540,35366,72906,106.1471
Portugal,2058,14,38041,35840,73881,106.1412
Portugal,2058,15,38640,36419,75059,106.0985
Portugal,2058,16,39065,36834,75899,106.0569
Portugal,2058,17,39470,37241,76711,105.9853
Portugal,2058,18,39970,37736,77706,105.9201
Portugal,2058,19,40383,38156,78539,105.8366
Portugal,2058,20,40630,38423,79053,105.744
Portugal,2058,21,41141,38937,80078,105.6604
Portugal,2058,22,41604,39402,81006,105.5885
Portugal,2058,23,41919,39736,81655,105.4938
Portugal,2058,24,42167,40002,82169,105.4122
Portugal,2058,25,42184,40054,82238,105.3178
Portugal,2058,26,42505,40390,82895,105.2364
Portugal,2058,27,42617,40541,83158,105.1207
Portugal,2058,28,42731,40679,83410,105.0444
Portugal,2058,29,42923,40902,83825,104.9411
Portugal,2058,30,43035,41050,84085,104.8356
Portugal,2058,31,43224,41266,84490,104.7448
Portugal,2058,32,43353,41434,84787,104.6315
Portugal,2058,33,43726,41833,85559,104.5251
Portugal,2058,34,44064,42207,86271,104.3997
Portugal,2058,35,44412,42599,87011,104.256
Portugal,2058,36,44819,43055,87874,104.0971
Portugal,2058,37,47014,45086,92100,104.2763
Portugal,2058,38,48360,46376,94736,104.2781
Portugal,2058,39,48174,47187,95361,102.0917
Portugal,2058,40,48128,46862,94990,102.7015
Portugal,2058,41,48931,47153,96084,103.7707
Portugal,2058,42,47983,46747,94730,102.644
Portugal,2058,43,46732,44805,91537,104.3009
Portugal,2058,44,46495,45348,91843,102.5293
Portugal,2058,45,50249,48238,98487,104.1689
Portugal,2058,46,53078,51218,104296,103.6315
Portugal,2058,47,54244,53667,107911,101.0751
Portugal,2058,48,52656,51607,104263,102.0327
Portugal,2058,49,54896,53204,108100,103.1802
Portugal,2058,50,53687,52445,106132,102.3682
Portugal,2058,51,54701,53945,108646,101.4014
Portugal,2058,52,56997,55400,112397,102.8827
Portugal,2058,53,55697,54940,110637,101.3779
Portugal,2058,54,56892,56011,112903,101.5729
Portugal,2058,55,57239,56282,113521,101.7004
Portugal,2058,56,56780,56025,112805,101.3476
Portugal,2058,57,60670,60371,121041,100.4953
Portugal,2058,58,58616,59156,117772,99.0872
Portugal,2058,59,56452,57065,113517,98.9258
Portugal,2058,60,55140,56682,111822,97.2796
Portugal,2058,61,54385,54990,109375,98.8998
Portugal,2058,62,52898,54118,107016,97.7457
Portugal,2058,63,51586,53705,105291,96.0544
Portugal,2058,64,52321,55789,108110,93.7837
Portugal,2058,65,51801,55939,107740,92.6027
Portugal,2058,66,52242,56184,108426,92.9838
Portugal,2058,67,51472,55970,107442,91.9636
Portugal,2058,68,50470,55156,105626,91.5041
Portugal,2058,69,50354,55776,106130,90.279
Portugal,2058,70,49490,55734,105224,88.7968
Portugal,2058,71,49322,56574,105896,87.1814
Portugal,2058,72,49819,57797,107616,86.1965
Portugal,2058,73,52222,61697,113919,84.6427
Portugal,2058,74,52407,62781,115188,83.4759
Portugal,2058,75,53611,65700,119311,81.5997
Portugal,2058,76,52850,66007,118857,80.0673
Portugal,2058,77,54174,68277,122451,79.3444
Portugal,2058,78,52958,67386,120344,78.589
Portugal,2058,79,52861,68745,121606,76.8943
Portugal,2058,80,55752,72855,128607,76.5246
Portugal,2058,81,54734,73275,128009,74.6967
Portugal,2058,82,52787,71359,124146,73.9739
Portugal,2058,83,49087,68821,117908,71.3256
Portugal,2058,84,45168,64509,109677,70.0181
Portugal,2058,85,42363,62117,104480,68.1987
Portugal,2058,86,38937,58307,97244,66.7793
Portugal,2058,87,34606,52855,87461,65.4735
Portugal,2058,88,30401,47889,78290,63.4822
Portugal,2058,89,26638,43511,70149,61.2213
Portugal,2058,90,22796,39456,62252,57.7758
Portugal,2058,91,19562,35220,54782,55.5423
Portugal,2058,92,16386,30716,47102,53.3468
Portugal,2058,93,13449,26558,40007,50.6401
Portugal,2058,94,10435,21650,32085,48.1986
Portugal,2058,95,7999,17485,25484,45.7478
Portugal,2058,96,5895,13623,19518,43.2724
Portugal,2058,97,4226,10166,14392,41.5699
Portugal,2058,98,2754,7110,9864,38.7342
Portugal,2058,99,1815,4994,6809,36.3436
Portugal,2058,100,2633,8243,10876,31.9423
Portugal,2059,0,32852,30908,63760,106.2896
Portugal,2059,1,33070,31115,64185,106.2831
Portugal,2059,2,33347,31384,64731,106.2548
Portugal,2059,3,33573,31601,65174,106.2403
Portugal,2059,4,33822,31836,65658,106.2382
Portugal,2059,5,34160,32157,66317,106.2288
Portugal,2059,6,34479,32458,66937,106.2265
Portugal,2059,7,34836,32798,67634,106.2138
Portugal,2059,8,35190,33137,68327,106.1955
Portugal,2059,9,35726,33636,69362,106.2136
Portugal,2059,10,36114,34005,70119,106.202
Portugal,2059,11,36426,34301,70727,106.1952
Portugal,2059,12,36872,34726,71598,106.1798
Portugal,2059,13,37154,35000,72154,106.1543
Portugal,2059,14,37579,35410,72989,106.1254
Portugal,2059,15,38098,35904,74002,106.1107
Portugal,2059,16,38718,36507,75225,106.0564
Portugal,2059,17,39165,36947,76112,106.0032
Portugal,2059,18,39593,37380,76973,105.9203
Portugal,2059,19,40113,37897,78010,105.8474
Portugal,2059,20,40543,38335,78878,105.7597
Portugal,2059,21,40803,38615,79418,105.6662
Portugal,2059,22,41324,39138,80462,105.5854
Portugal,2059,23,41791,39606,81397,105.5168
Portugal,2059,24,42106,39939,82045,105.4258
Portugal,2059,25,42353,40202,82555,105.3505
Portugal,2059,26,42364,40248,82612,105.2574
Portugal,2059,27,42677,40575,83252,105.1805
Portugal,2059,28,42781,40716,83497,105.0717
Portugal,2059,29,42885,40843,83728,104.9996
Portugal,2059,30,43067,41055,84122,104.9007
Portugal,2059,31,43169,41191,84360,104.802
Portugal,2059,32,43349,41397,84746,104.7153
Portugal,2059,33,43468,41554,85022,104.6061
Portugal,2059,34,43829,41942,85771,104.4991
Portugal,2059,35,44157,42306,86463,104.3753
Portugal,2059,36,44496,42689,87185,104.2329
Portugal,2059,37,44894,43137,88031,104.0731
Portugal,2059,38,47079,45158,92237,104.254
Portugal,2059,39,48414,46439,94853,104.2529
Portugal,2059,40,48217,47242,95459,102.0638
Portugal,2059,41,48160,46908,95068,102.6691
Portugal,2059,42,48952,47191,96143,103.7316
Portugal,2059,43,47995,46779,94774,102.5995
Portugal,2059,44,46735,44832,91567,104.2447
Portugal,2059,45,46487,45368,91855,102.4665
Portugal,2059,46,50224,48249,98473,104.0933
Portugal,2059,47,53034,51220,104254,103.5416
Portugal,2059,48,54184,53660,107844,100.9765
Portugal,2059,49,52585,51594,104179,101.9208
Portugal,2059,50,54806,53184,107990,103.0498
Portugal,2059,51,53580,52419,105999,102.2148
Portugal,2059,52,54572,53910,108482,101.228
Portugal,2059,53,56844,55355,112199,102.6899
Portugal,2059,54,55534,54891,110425,101.1714
Portugal,2059,55,56710,55956,112666,101.3475
Portugal,2059,56,57038,56219,113257,101.4568
Portugal,2059,57,56561,55955,112516,101.083
Portugal,2059,58,60414,60289,120703,100.2073
Portugal,2059,59,58344,59067,117411,98.776
Portugal,2059,60,56166,56968,113134,98.5922
Portugal,2059,61,54834,56574,111408,96.9244
Portugal,2059,62,54069,54881,108950,98.5204
Portugal,2059,63,52585,54008,106593,97.3652
Portugal,2059,64,51271,53589,104860,95.6745
Portugal,2059,65,51992,55660,107652,93.41
Portugal,2059,66,51462,55801,107263,92.2242
Portugal,2059,67,51877,56035,107912,92.5796
Portugal,2059,68,51086,55808,106894,91.5388
Portugal,2059,69,50052,54972,105024,91.05
Portugal,2059,70,49910,55573,105483,89.8098
Portugal,2059,71,49018,55509,104527,88.3064
Portugal,2059,72,48809,56318,105127,86.6668
Portugal,2059,73,49262,57509,106771,85.6596
Portugal,2059,74,51579,61350,112929,84.0733
Portugal,2059,75,51704,62386,114090,82.8776
Portugal,2059,76,52813,65228,118041,80.9668
Portugal,2059,77,51958,65452,117410,79.3834
Portugal,2059,78,53144,67607,120751,78.6072
Portugal,2059,79,51802,66595,118397,77.7866
Portugal,2059,80,51515,67769,119284,76.0156
Portugal,2059,81,54049,71573,125622,75.5159
Portugal,2059,82,52770,71726,124496,73.5716
Portugal,2059,83,50611,69591,120202,72.7264
Portugal,2059,84,46738,66789,113527,69.9786
Portugal,2059,85,42638,62196,104834,68.5542
Portugal,2059,86,39533,59338,98871,66.6234
Portugal,2059,87,35876,55115,90991,65.093
Portugal,2059,88,31452,49431,80883,63.6281
Portugal,2059,89,27101,44146,71247,61.3895
Portugal,2059,90,23278,39480,62758,58.9615
Portugal,2059,91,19537,35176,54713,55.5407
Portugal,2059,92,16460,30885,47345,53.2945
Portugal,2059,93,13574,26587,40161,51.055
Portugal,2059,94,10865,22517,33382,48.2524
Portugal,2059,95,8154,17837,25991,45.714
Portugal,2059,96,6030,13937,19967,43.2661
Portugal,2059,97,4294,10499,14793,40.8991
Portugal,2059,98,2970,7565,10535,39.2597
Portugal,2059,99,1862,5096,6958,36.5385
Portugal,2059,100,2740,8575,11315,31.9534
Portugal,2060,0,32606,30676,63282,106.2916
Portugal,2060,1,32914,30972,63886,106.2702
Portugal,2060,2,33126,31171,64297,106.2719
Portugal,2060,3,33395,31432,64827,106.2452
Portugal,2060,4,33614,31642,65256,106.2322
Portugal,2060,5,33856,31871,65727,106.2282
Portugal,2060,6,34190,32186,66376,106.2263
Portugal,2060,7,34504,32483,66987,106.2217
Portugal,2060,8,34858,32819,67677,106.2129
Portugal,2060,9,35208,33156,68364,106.1889
Portugal,2060,10,35742,33653,69395,106.2075
Portugal,2060,11,36130,34022,70152,106.196
Portugal,2060,12,36445,34321,70766,106.1886
Portugal,2060,13,36899,34756,71655,106.1658
Portugal,2060,14,37194,35044,72238,106.1351
Portugal,2060,15,37636,35474,73110,106.0946
Portugal,2060,16,38175,35992,74167,106.0652
Portugal,2060,17,38818,36621,75439,105.9993
Portugal,2060,18,39288,37086,76374,105.9376
Portugal,2060,19,39737,37541,77278,105.8496
Portugal,2060,20,40273,38076,78349,105.77
Portugal,2060,21,40716,38527,79243,105.6817
Portugal,2060,22,40986,38816,79802,105.5905
Portugal,2060,23,41511,39342,80853,105.5132
Portugal,2060,24,41978,39809,81787,105.4485
Portugal,2060,25,42291,40139,82430,105.3614
Portugal,2060,26,42533,40396,82929,105.2901
Portugal,2060,27,42537,40433,82970,105.2037
Portugal,2060,28,42841,40751,83592,105.1287
Portugal,2060,29,42935,40880,83815,105.0269
Portugal,2060,30,43029,40996,84025,104.959
Portugal,2060,31,43202,41197,84399,104.8669
Portugal,2060,32,43294,41322,84616,104.7723
Portugal,2060,33,43464,41517,84981,104.6896
Portugal,2060,34,43571,41663,85234,104.5796
Portugal,2060,35,43922,42042,85964,104.4717
Portugal,2060,36,44241,42397,86638,104.3494
Portugal,2060,37,44572,42771,87343,104.2108
Portugal,2060,38,44960,43209,88169,104.0524
Portugal,2060,39,47134,45221,92355,104.2303
Portugal,2060,40,48457,46494,94951,104.2221
Portugal,2060,41,48249,47288,95537,102.0322
Portugal,2060,42,48182,46946,95128,102.6328
Portugal,2060,43,48963,47223,96186,103.6846
Portugal,2060,44,47997,46805,94802,102.5467
Portugal,2060,45,46727,44853,91580,104.1781
Portugal,2060,46,46468,45381,91849,102.3953
Portugal,2060,47,50186,48254,98440,104.0038
Portugal,2060,48,52978,51215,104193,103.4424
Portugal,2060,49,54112,53646,107758,100.8687
Portugal,2060,50,52502,51577,104079,101.7934
Portugal,2060,51,54698,53159,107857,102.8951
Portugal,2060,52,53457,52386,105843,102.0444
Portugal,2060,53,54430,53868,108298,101.0433
Portugal,2060,54,56680,55307,111987,102.4825
Portugal,2060,55,55360,54838,110198,100.9519
Portugal,2060,56,56514,55895,112409,101.1074
Portugal,2060,57,56821,56151,112972,101.1932
Portugal,2060,58,56327,55882,112209,100.7963
Portugal,2060,59,60138,60200,120338,99.897
Portugal,2060,60,58053,58968,117021,98.4483
Portugal,2060,61,55860,56861,112721,98.2396
Portugal,2060,62,54520,56463,110983,96.5588
Portugal,2060,63,53754,54772,108526,98.1414
Portugal,2060,64,52269,53894,106163,96.9848
Portugal,2060,65,50955,53469,104424,95.2982
Portugal,2060,66,51658,55527,107185,93.0322
Portugal,2060,67,51109,55657,106766,91.8285
Portugal,2060,68,51494,55876,107370,92.1576
Portugal,2060,69,50671,55627,106298,91.0907
Portugal,2060,70,49619,54777,104396,90.5836
Portugal,2060,71,49443,55354,104797,89.3215
Portugal,2060,72,48519,55265,103784,87.7934
Portugal,2060,73,48275,56046,104321,86.1346
Portugal,2060,74,48669,57194,105863,85.0946
Portugal,2060,75,50902,60974,111876,83.4815
Portugal,2060,76,50950,61951,112901,82.2424
Portugal,2060,77,51939,64695,116634,80.2829
Portugal,2060,78,50990,64827,115817,78.6555
Portugal,2060,79,52007,66834,118841,77.8152
Portugal,2060,80,50508,65673,116181,76.9083
Portugal,2060,81,49968,66602,116570,75.0248
Portugal,2060,82,52140,70091,122231,74.389
Portugal,2060,83,50627,69984,120611,72.3408
Portugal,2060,84,48224,67576,115800,71.3626
Portugal,2060,85,44156,64437,108593,68.5258
Portugal,2060,86,39824,59459,99283,66.9772
Portugal,2060,87,36460,56139,92599,64.9459
Portugal,2060,88,32641,51595,84236,63.2639
Portugal,2060,89,28069,45615,73684,61.5346
Portugal,2060,90,23710,40101,63811,59.1257
Portugal,2060,91,19975,35239,55214,56.6844
Portugal,2060,92,16460,30885,47345,53.2945
Portugal,2060,93,13655,26770,40425,51.0086
Portugal,2060,94,10981,22574,33555,48.6445
Portugal,2060,95,8503,18579,27082,45.7667
Portugal,2060,96,6156,14239,20395,43.2334
Portugal,2060,97,4398,10756,15154,40.8888
Portugal,2060,98,3021,7824,10845,38.612
Portugal,2060,99,2010,5429,7439,37.0234
Portugal,2060,100,2837,8862,11699,32.0131
Portugal,2061,0,32557,30627,63184,106.3016
Portugal,2061,1,32668,30740,63408,106.272
Portugal,2061,2,32970,31028,63998,106.2589
Portugal,2061,3,33174,31220,64394,106.2588
Portugal,2061,4,33435,31473,64908,106.2339
Portugal,2061,5,33648,31677,65325,106.2222
Portugal,2061,6,33886,31901,65787,106.2224
Portugal,2061,7,34215,32211,66426,106.2215
Portugal,2061,8,34526,32505,67031,106.2175
Portugal,2061,9,34876,32838,67714,106.2062
Portugal,2061,10,35224,33172,68396,106.1859
Portugal,2061,11,35758,33670,69428,106.2014
Portugal,2061,12,36149,34043,70192,106.1863
Portugal,2061,13,36472,34351,70823,106.1745
Portugal,2061,14,36938,34800,71738,106.1437
Portugal,2061,15,37250,35109,72359,106.0982
Portugal,2061,16,37713,35562,73275,106.0486
Portugal,2061,17,38276,36106,74382,106.0101
Portugal,2061,18,38941,36760,75701,105.9331
Portugal,2061,19,39431,37247,76678,105.8636
Portugal,2061,20,39897,37720,77617,105.7715
Portugal,2061,21,40446,38268,78714,105.6914
Portugal,2061,22,40899,38728,79627,105.6058
Portugal,2061,23,41173,39020,80193,105.5177
Portugal,2061,24,41698,39545,81243,105.4444
Portugal,2061,25,42164,40010,82174,105.3837
Portugal,2061,26,42472,40333,82805,105.3033
Portugal,2061,27,42706,40582,83288,105.2338
Portugal,2061,28,42701,40609,83310,105.1516
Portugal,2061,29,42996,40915,83911,105.0862
Portugal,2061,30,43080,41034,84114,104.9861
Portugal,2061,31,43164,41138,84302,104.9249
Portugal,2061,32,43327,41328,84655,104.8369
Portugal,2061,33,43410,41443,84853,104.7463
Portugal,2061,34,43568,41627,85195,104.6628
Portugal,2061,35,43665,41763,85428,104.5543
Portugal,2061,36,44007,42133,86140,104.4478
Portugal,2061,37,44317,42479,86796,104.3268
Portugal,2061,38,44638,42844,87482,104.1873
Portugal,2061,39,45017,43273,88290,104.0302
Portugal,2061,40,47178,45277,92455,104.1986
Portugal,2061,41,48489,46541,95030,104.1856
Portugal,2061,42,48272,47327,95599,101.9967
Portugal,2061,43,48195,46979,95174,102.5884
Portugal,2061,44,48965,47250,96215,103.6296
Portugal,2061,45,47988,46826,94814,102.4815
Portugal,2061,46,46709,44867,91576,104.1055
Portugal,2061,47,46437,45388,91825,102.3112
Portugal,2061,48,50136,48252,98388,103.9045
Portugal,2061,49,52910,51205,104115,103.3298
Portugal,2061,50,54027,53628,107655,100.744
Portugal,2061,51,52402,51553,103955,101.6468
Portugal,2061,52,54574,53126,107700,102.7256
Portugal,2061,53,53320,52347,105667,101.8588
Portugal,2061,54,54276,53823,108099,100.8416
Portugal,2061,55,56505,55255,111760,102.2622
Portugal,2061,56,55172,54780,109952,100.7156
Portugal,2061,57,56303,55829,112132,100.849
Portugal,2061,58,56589,56079,112668,100.9094
Portugal,2061,59,56074,55802,111876,100.4874
Portugal,2061,60,59842,60101,119943,99.5691
Portugal,2061,61,57740,58859,116599,98.0988
Portugal,2061,62,55544,56752,112296,97.8714
Portugal,2061,63,54207,56353,110560,96.1919
Portugal,2061,64,53436,54659,108095,97.7625
Portugal,2061,65,51952,53776,105728,96.6082
Portugal,2061,66,50633,53344,103977,94.9179
Portugal,2061,67,51310,55387,106697,92.6391
Portugal,2061,68,50739,55504,106243,91.415
Portugal,2061,69,51083,55700,106783,91.711
Portugal,2061,70,50240,55434,105674,90.6303
Portugal,2061,71,49164,54567,103731,90.0984
Portugal,2061,72,48949,55117,104066,88.8093
Portugal,2061,73,47998,55005,103003,87.2612
Portugal,2061,74,47704,55747,103451,85.5723
Portugal,2061,75,48042,56854,104896,84.5007
Portugal,2061,76,50174,60560,110734,82.8501
Portugal,2061,77,50124,61457,111581,81.5595
Portugal,2061,78,50990,64093,115083,79.5563
Portugal,2061,79,49918,64105,114023,77.8691
Portugal,2061,80,50729,65931,116660,76.9426
Portugal,2061,81,49014,64567,113581,75.9118
Portugal,2061,82,48228,65252,113480,73.9104
Portugal,2061,83,50053,68423,118476,73.1523
Portugal,2061,84,48272,67996,116268,70.9924
Portugal,2061,85,45594,65240,110834,69.8866
Portugal,2061,86,41276,61648,102924,66.9543
Portugal,2061,87,36761,56301,93062,65.2937
Portugal,2061,88,33204,52603,85807,63.1219
Portugal,2061,89,29160,47661,76821,61.1821
Portugal,2061,90,24584,41482,66066,59.2643
Portugal,2061,91,20369,35836,56205,56.8395
Portugal,2061,92,16848,30979,47827,54.3852
Portugal,2061,93,13672,26807,40479,51.0016
Portugal,2061,94,11061,22762,33823,48.5941
Portugal,2061,95,8605,18653,27258,46.132
Portugal,2061,96,6427,14852,21279,43.2736
Portugal,2061,97,4495,11005,15500,40.8451
Portugal,2061,98,3098,8027,11125,38.5947
Portugal,2061,99,2047,5622,7669,36.4105
Portugal,2061,100,2991,9278,12269,32.2376
Portugal,2062,0,32544,30615,63159,106.3008
Portugal,2062,1,32619,30691,63310,106.282
Portugal,2062,2,32724,30796,63520,106.2606
Portugal,2062,3,33018,31077,64095,106.2458
Portugal,2062,4,33215,31261,64476,106.2506
Portugal,2062,5,33470,31508,64978,106.227
Portugal,2062,6,33678,31707,65385,106.2163
Portugal,2062,7,33911,31926,65837,106.2175
Portugal,2062,8,34236,32233,66469,106.2141
Portugal,2062,9,34544,32523,67067,106.2141
Portugal,2062,10,34892,32855,67747,106.2
Portugal,2062,11,35240,33189,68429,106.1798
Portugal,2062,12,35778,33690,69468,106.1977
Portugal,2062,13,36176,34073,70249,106.172
Portugal,2062,14,36511,34395,70906,106.1521
Portugal,2062,15,36995,34864,71859,106.1123
Portugal,2062,16,37328,35197,72525,106.0545
Portugal,2062,17,37814,35676,73490,105.9928
Portugal,2062,18,38399,36245,74644,105.9429
Portugal,2062,19,39085,36921,76006,105.8612
Portugal,2062,20,39591,37426,77017,105.7847
Portugal,2062,21,40070,37913,77983,105.6893
Portugal,2062,22,40629,38469,79098,105.6149
Portugal,2062,23,41086,38932,80018,105.5327
Portugal,2062,24,41361,39223,80584,105.4509
Portugal,2062,25,41884,39746,81630,105.3792
Portugal,2062,26,42344,40204,82548,105.3229
Portugal,2062,27,42645,40519,83164,105.2469
Portugal,2062,28,42870,40757,83627,105.1844
Portugal,2062,29,42855,40773,83628,105.1063
Portugal,2062,30,43140,41068,84208,105.0453
Portugal,2062,31,43215,41176,84391,104.9519
Portugal,2062,32,43289,41269,84558,104.8947
Portugal,2062,33,43443,41449,84892,104.8107
Portugal,2062,34,43514,41553,85067,104.7193
Portugal,2062,35,43662,41727,85389,104.6373
Portugal,2062,36,43750,41854,85604,104.53
Portugal,2062,37,44084,42215,86299,104.4273
Portugal,2062,38,44385,42552,86937,104.3077
Portugal,2062,39,44695,42908,87603,104.1647
Portugal,2062,40,45063,43329,88392,104.0019
Portugal,2062,41,47212,45324,92536,104.1656
Portugal,2062,42,48512,46580,95092,104.1477
Portugal,2062,43,48285,47360,95645,101.9531
Portugal,2062,44,48198,47006,95204,102.5358
Portugal,2062,45,48956,47271,96227,103.5646
Portugal,2062,46,47969,46839,94808,102.4125
Portugal,2062,47,46678,44875,91553,104.0178
Portugal,2062,48,46395,45389,91784,102.2164
Portugal,2062,49,50075,48245,98320,103.7931
Portugal,2062,50,52829,51189,104018,103.2038
Portugal,2062,51,53925,53604,107529,100.5988
Portugal,2062,52,52286,51524,103810,101.4789
Portugal,2062,53,54436,53088,107524,102.5392
Portugal,2062,54,53173,52305,105478,101.6595
Portugal,2062,55,54112,53774,107886,100.6286
Portugal,2062,56,56316,55198,111514,102.0254
Portugal,2062,57,54970,54717,109687,100.4624
Portugal,2062,58,56077,55759,111836,100.5703
Portugal,2062,59,56340,56000,112340,100.6071
Portugal,2062,60,55803,55713,111516,100.1615
Portugal,2062,61,59524,59993,119517,99.2182
Portugal,2062,62,57419,58749,116168,97.7361
Portugal,2062,63,55231,56645,111876,97.5038
Portugal,2062,64,53893,56240,110133,95.8268
Portugal,2062,65,53118,54542,107660,97.3892
Portugal,2062,66,51630,53653,105283,96.2295
Portugal,2062,67,50299,53213,103512,94.5239
Portugal,2062,68,50946,55238,106184,92.23
Portugal,2062,69,50343,55333,105676,90.9819
Portugal,2062,70,50658,55512,106170,91.2559
Portugal,2062,71,49788,55228,105016,90.1499
Portugal,2062,72,48683,54340,103023,89.5896
Portugal,2062,73,48434,54865,103299,88.2785
Portugal,2062,74,47442,54720,102162,86.6996
Portugal,2062,75,47103,55425,102528,84.9851
Portugal,2062,76,47369,56478,103847,83.8716
Portugal,2062,77,49376,60091,109467,82.1687
Portugal,2062,78,49226,60901,110127,80.8295
Portugal,2062,79,49939,63397,113336,78.7719
Portugal,2062,80,48715,63259,111974,77.0088
Portugal,2062,81,49254,64845,114099,75.9565
Portugal,2062,82,47335,63285,110620,74.7966
Portugal,2062,83,46328,63731,110059,72.693
Portugal,2062,84,47758,66518,114276,71.7971
Portugal,2062,85,45675,65688,111363,69.5332
Portugal,2062,86,42657,62463,105120,68.2916
Portugal,2062,87,38137,58423,96560,65.2774
Portugal,2062,88,33514,52805,86319,63.4675
Portugal,2062,89,29696,48642,78338,61.0501
Portugal,2062,90,25570,43390,68960,58.9306
Portugal,2062,91,21145,37113,58258,56.9746
Portugal,2062,92,17202,31543,48745,54.5351
Portugal,2062,93,14013,26925,40938,52.0446
Portugal,2062,94,11090,22826,33916,48.5849
Portugal,2062,95,8679,18835,27514,46.0791
Portugal,2062,96,6513,14933,21446,43.6148
Portugal,2062,97,4700,11495,16195,40.8873
Portugal,2062,98,3171,8223,11394,38.5626
Portugal,2062,99,2102,5776,7878,36.392
Portugal,2062,100,3113,9684,12797,32.1458
Portugal,2063,0,32285,30372,62657,106.2986
Portugal,2063,1,32606,30680,63286,106.2777
Portugal,2063,2,32675,30748,63423,106.2671
Portugal,2063,3,32772,30845,63617,106.2474
Portugal,2063,4,33059,31118,64177,106.2375
Portugal,2063,5,33249,31296,64545,106.2404
Portugal,2063,6,33500,31537,65037,106.2244
Portugal,2063,7,33703,31732,65435,106.2114
Portugal,2063,8,33933,31948,65881,106.2132
Portugal,2063,9,34255,32251,66506,106.2138
Portugal,2063,10,34560,32540,67100,106.2077
Portugal,2063,11,34909,32871,67780,106.2
Portugal,2063,12,35260,33210,68470,106.1728
Portugal,2063,13,35804,33720,69524,106.1803
Portugal,2063,14,36215,34117,70332,106.1494
Portugal,2063,15,36568,34459,71027,106.1203
Portugal,2063,16,37073,34952,72025,106.0683
Portugal,2063,17,37428,35311,72739,105.9953
Portugal,2063,18,37937,35815,73752,105.9249
Portugal,2063,19,38543,36407,74950,105.867
Portugal,2063,20,39245,37100,76345,105.7817
Portugal,2063,21,39765,37619,77384,105.7046
Portugal,2063,22,40253,38114,78367,105.6121
Portugal,2063,23,40817,38674,79491,105.5412
Portugal,2063,24,41274,39136,80410,105.463
Portugal,2063,25,41547,39424,80971,105.385
Portugal,2063,26,42065,39940,82005,105.3205
Portugal,2063,27,42518,40389,82907,105.2712
Portugal,2063,28,42809,40694,83503,105.1973
Portugal,2063,29,43024,40922,83946,105.1366
Portugal,2063,30,43000,40926,83926,105.0677
Portugal,2063,31,43275,41210,84485,105.0109
Portugal,2063,32,43340,41307,84647,104.9217
Portugal,2063,33,43405,41390,84795,104.8683
Portugal,2063,34,43547,41559,85106,104.7836
Portugal,2063,35,43608,41653,85261,104.6935
Portugal,2063,36,43747,41818,85565,104.6128
Portugal,2063,37,43827,41936,85763,104.5093
Portugal,2063,38,44151,42288,86439,104.4055
Portugal,2063,39,44442,42616,87058,104.2848
Portugal,2063,40,44742,42965,87707,104.1359
Portugal,2063,41,45098,43378,88476,103.9651
Portugal,2063,42,47236,45365,92601,104.1243
Portugal,2063,43,48526,46614,95140,104.1018
Portugal,2063,44,48289,47387,95676,101.9035
Portugal,2063,45,48191,47027,95218,102.4752
Portugal,2063,46,48937,47285,96222,103.4937
Portugal,2063,47,47938,46847,94785,102.3289
Portugal,2063,48,46637,44877,91514,103.9218
Portugal,2063,49,46342,45385,91727,102.1086
Portugal,2063,50,50002,48232,98234,103.6698
Portugal,2063,51,52732,51168,103900,103.0566
Portugal,2063,52,53807,53573,107380,100.4368
Portugal,2063,53,52157,51488,103645,101.2993
Portugal,2063,54,54288,53046,107334,102.3414
Portugal,2063,55,53015,52260,105275,101.4447
Portugal,2063,56,53935,53721,107656,100.3984
Portugal,2063,57,56112,55136,111248,101.7702
Portugal,2063,58,54753,54650,109403,100.1885
Portugal,2063,59,55834,55682,111516,100.273
Portugal,2063,60,56071,55913,111984,100.2826
Portugal,2063,61,55512,55615,111127,99.8148
Portugal,2063,62,59198,59883,119081,98.8561
Portugal,2063,63,57101,58640,115741,97.3755
Portugal,2063,64,54916,56533,111449,97.1397
Portugal,2063,65,53577,56122,109699,95.4652
Portugal,2063,66,52795,54421,107216,97.0122
Portugal,2063,67,51296,53525,104821,95.8356
Portugal,2063,68,49950,53075,103025,94.1121
Portugal,2063,69,50555,55073,105628,91.7963
Portugal,2063,70,49932,55152,105084,90.5352
Portugal,2063,71,50212,55311,105523,90.7812
Portugal,2063,72,49310,55004,104314,89.648
Portugal,2063,73,48181,54098,102279,89.0624
Portugal,2063,74,47885,54588,102473,87.7207
Portugal,2063,75,46856,54412,101268,86.1134
Portugal,2063,76,46458,55069,101527,84.3633
Portugal,2063,77,46632,56053,102685,83.1927
Portugal,2063,78,48510,59562,108072,81.4445
Portugal,2063,79,48231,60257,108488,80.0422
Portugal,2063,80,48757,62581,111338,77.9102
Portugal,2063,81,47322,62240,109562,76.0315
Portugal,2063,82,47593,63584,111177,74.8506
Portugal,2063,83,45498,61840,107338,73.5737
Portugal,2063,84,44236,61991,106227,71.3587
Portugal,2063,85,45226,64301,109527,70.3348
Portugal,2063,86,42771,62939,105710,67.9563
Portugal,2063,87,39451,59244,98695,66.5907
Portugal,2063,88,34804,54846,89650,63.4577
Portugal,2063,89,30006,48878,78884,61.3896
Portugal,2063,90,26071,44332,70403,58.8085
Portugal,2063,91,22020,38866,60886,56.6562
Portugal,2063,92,17880,32707,50587,54.6672
Portugal,2063,93,14327,27452,41779,52.1893
Portugal,2063,94,11384,22959,34343,49.584
Portugal,2063,95,8715,18915,27630,46.0745
Portugal,2063,96,6579,15100,21679,43.5695
Portugal,2063,97,4769,11574,16343,41.2044
Portugal,2063,98,3319,8602,11921,38.5841
Portugal,2063,99,2154,5925,8079,36.3544
Portugal,2063,100,3220,10055,13275,32.0239
Portugal,2064,0,32224,30315,62539,106.2972
Portugal,2064,1,32348,30437,62785,106.2785
Portugal,2064,2,32662,30736,63398,106.2663
Portugal,2064,3,32723,30796,63519,106.2573
Portugal,2064,4,32813,30886,63699,106.2391
Portugal,2064,5,33093,31153,64246,106.2273
Portugal,2064,6,33279,31325,64604,106.2378
Portugal,2064,7,33525,31563,65088,106.2161
Portugal,2064,8,33725,31754,65479,106.2071
Portugal,2064,9,33951,31966,65917,106.2097
Portugal,2064,10,34271,32268,66539,106.2074
Portugal,2064,11,34576,32557,67133,106.2014
Portugal,2064,12,34928,32892,67820,106.19
Portugal,2064,13,35286,33240,68526,106.1552
Portugal,2064,14,35844,33764,69608,106.1604
Portugal,2064,15,36272,34181,70453,106.1174
Portugal,2064,16,36646,34548,71194,106.0727
Portugal,2064,17,37173,35066,72239,106.0087
Portugal,2064,18,37552,35450,73002,105.9295
Portugal,2064,19,38081,35976,74057,105.8511
Portugal,2064,20,38703,36586,75289,105.7864
Portugal,2064,21,39419,37293,76712,105.7008
Portugal,2064,22,39948,37820,77768,105.6267
Portugal,2064,23,40441,38318,78759,105.5405
Portugal,2064,24,41005,38877,79882,105.4737
Portugal,2064,25,41460,39336,80796,105.3996
Portugal,2064,26,41728,39618,81346,105.3259
Portugal,2064,27,42238,40126,82364,105.2634
Portugal,2064,28,42682,40565,83247,105.2188
Portugal,2064,29,42964,40859,83823,105.1519
Portugal,2064,30,43169,41075,84244,105.098
Portugal,2064,31,43136,41069,84205,105.033
Portugal,2064,32,43401,41342,84743,104.9804
Portugal,2064,33,43456,41428,84884,104.8952
Portugal,2064,34,43510,41500,85010,104.8434
Portugal,2064,35,43641,41659,85300,104.7577
Portugal,2064,36,43694,41744,85438,104.6713
Portugal,2064,37,43824,41901,85725,104.5894
Portugal,2064,38,43895,42010,85905,104.487
Portugal,2064,39,44209,42353,86562,104.3822
Portugal,2064,40,44489,42673,87162,104.2556
Portugal,2064,41,44778,43014,87792,104.101
Portugal,2064,42,45125,43419,88544,103.9292
Portugal,2064,43,47252,45399,92651,104.0816
Portugal,2064,44,48530,46642,95172,104.0479
Portugal,2064,45,48283,47409,95692,101.8435
Portugal,2064,46,48173,47042,95215,102.4042
Portugal,2064,47,48905,47292,96197,103.4107
Portugal,2064,48,47896,46848,94744,102.237
Portugal,2064,49,46585,44874,91459,103.8129
Portugal,2064,50,46278,45376,91654,101.9878
Portugal,2064,51,49913,48215,98128,103.5217
Portugal,2064,52,52619,51141,103760,102.89
Portugal,2064,53,53676,53536,107212,100.2615
Portugal,2064,54,52018,51449,103467,101.1059
Portugal,2064,55,54129,53001,107130,102.1283
Portugal,2064,56,52844,52209,105053,101.2163
Portugal,2064,57,53743,53662,107405,100.1509
Portugal,2064,58,55894,55070,110964,101.4963
Portugal,2064,59,54519,54578,109097,99.8919
Portugal,2064,60,55572,55598,111170,99.9532
Portugal,2064,61,55783,55818,111601,99.9373
Portugal,2064,62,55213,55517,110730,99.4524
Portugal,2064,63,58874,59774,118648,98.4943
Portugal,2064,64,56780,58527,115307,97.0151
Portugal,2064,65,54600,56418,111018,96.7776
Portugal,2064,66,53257,56001,109258,95.1001
Portugal,2064,67,52459,54295,106754,96.6185
Portugal,2064,68,50946,53390,104336,95.4224
Portugal,2064,69,49574,52921,102495,93.6755
Portugal,2064,70,50151,54898,105049,91.3531
Portugal,2064,71,49500,54957,104457,90.0704
Portugal,2064,72,49739,55093,104832,90.2819
Portugal,2064,73,48813,54766,103579,89.1301
Portugal,2064,74,47646,53834,101480,88.5054
Portugal,2064,75,47306,54291,101597,87.1341
Portugal,2064,76,46227,54074,100301,85.4884
Portugal,2064,77,45748,54667,100415,83.6849
Portugal,2064,78,45830,55574,101404,82.4666
Portugal,2064,79,47548,58950,106498,80.6582
Portugal,2064,80,47109,59503,106612,79.1708
Portugal,2064,81,47385,61598,108983,76.9262
Portugal,2064,82,45750,61060,106810,74.9263
Portugal,2064,83,45773,62167,107940,73.6291
Portugal,2064,84,43472,60189,103661,72.2258
Portugal,2064,85,41920,59969,101889,69.9028
Portugal,2064,86,42383,61661,104044,68.7355
Portugal,2064,87,39590,59752,99342,66.2572
Portugal,2064,88,36036,55676,91712,64.7245
Portugal,2064,89,31193,50826,82019,61.3721
Portugal,2064,90,26371,44603,70974,59.1238
Portugal,2064,91,22476,39762,62238,56.5263
Portugal,2064,92,18641,34300,52941,54.3469
Portugal,2064,93,14911,28510,43421,52.3009
Portugal,2064,94,11654,23446,35100,49.7057
Portugal,2064,95,8957,19057,28014,47.0011
Portugal,2064,96,6614,15189,21803,43.5447
Portugal,2064,97,4823,11723,16546,41.1413
Portugal,2064,98,3372,8675,12047,38.8703
Portugal,2064,99,2257,6207,8464,36.3622
Portugal,2064,100,3320,10396,13716,31.9354
Portugal,2065,0,32145,30242,62387,106.2926
Portugal,2065,1,32286,30380,62666,106.2739
Portugal,2065,2,32404,30493,62897,106.267
Portugal,2065,3,32710,30785,63495,106.253
Portugal,2065,4,32764,30837,63601,106.249
Portugal,2065,5,32848,30921,63769,106.232
Portugal,2065,6,33123,31182,64305,106.2247
Portugal,2065,7,33304,31351,64655,106.2295
Portugal,2065,8,33547,31584,65131,106.2152
Portugal,2065,9,33743,31772,65515,106.2036
Portugal,2065,10,33967,31983,65950,106.2033
Portugal,2065,11,34287,32285,66572,106.201
Portugal,2065,12,34596,32578,67174,106.1944
Portugal,2065,13,34955,32922,67877,106.1752
Portugal,2065,14,35326,33284,68610,106.1351
Portugal,2065,15,35901,33829,69730,106.1249
Portugal,2065,16,36350,34270,70620,106.0694
Portugal,2065,17,36747,34662,71409,106.0152
Portugal,2065,18,37297,35206,72503,105.9393
Portugal,2065,19,37696,35611,73307,105.8549
Portugal,2065,20,38242,36156,74398,105.7694
Portugal,2065,21,38877,36779,75656,105.7043
Portugal,2065,22,39603,37494,77097,105.6249
Portugal,2065,23,40136,38024,78160,105.5544
Portugal,2065,24,40629,38522,79151,105.4696
Portugal,2065,25,41191,39078,80269,105.4071
Portugal,2065,26,41641,39530,81171,105.3402
Portugal,2065,27,41901,39804,81705,105.2683
Portugal,2065,28,42403,40301,82704,105.2158
Portugal,2065,29,42837,40730,83567,105.1731
Portugal,2065,30,43109,41013,84122,105.1106
Portugal,2065,31,43305,41218,84523,105.0633
Portugal,2065,32,43262,41200,84462,105.0049
Portugal,2065,33,43517,41463,84980,104.9538
Portugal,2065,34,43561,41538,85099,104.8702
Portugal,2065,35,43604,41601,85205,104.8148
Portugal,2065,36,43727,41750,85477,104.7353
Portugal,2065,37,43771,41827,85598,104.6477
Portugal,2065,38,43892,41974,85866,104.5695
Portugal,2065,39,43953,42075,86028,104.4635
Portugal,2065,40,44256,42410,86666,104.3527
Portugal,2065,41,44526,42723,87249,104.2202
Portugal,2065,42,44806,43056,87862,104.0645
Portugal,2065,43,45143,43455,88598,103.8845
Portugal,2065,44,47258,45428,92686,104.0284
Portugal,2065,45,48524,46664,95188,103.9859
Portugal,2065,46,48266,47424,95690,101.7755
Portugal,2065,47,48144,47050,95194,102.3252
Portugal,2065,48,48862,47294,96156,103.3154
Portugal,2065,49,47843,46844,94687,102.1326
Portugal,2065,50,46522,44866,91388,103.691
Portugal,2065,51,46200,45362,91562,101.8474
Portugal,2065,52,49810,48192,98002,103.3574
Portugal,2065,53,52494,51108,103602,102.7119
Portugal,2065,54,53535,53496,107031,100.0729
Portugal,2065,55,51869,51407,103276,100.8987
Portugal,2065,56,53957,52951,106908,101.8999
Portugal,2065,57,52660,52154,104814,100.9702
Portugal,2065,58,53538,53600,107138,99.8843
Portugal,2065,59,55658,54999,110657,101.1982
Portugal,2065,60,54268,54497,108765,99.5798
Portugal,2065,61,55290,55505,110795,99.6126
Portugal,2065,62,55487,55721,111208,99.5801
Portugal,2065,63,54917,55419,110336,99.0942
Portugal,2065,64,58549,59662,118211,98.1345
Portugal,2065,65,56458,58411,114869,96.6565
Portugal,2065,66,54279,56300,110579,96.4103
Portugal,2065,67,52925,55875,108800,94.7204
Portugal,2065,68,52107,54161,106268,96.2076
Portugal,2065,69,50569,53239,103808,94.9849
Portugal,2065,70,49184,52757,101941,93.2274
Portugal,2065,71,49725,54710,104435,90.8883
Portugal,2065,72,49043,54747,103790,89.5812
Portugal,2065,73,49246,54862,104108,89.7634
Portugal,2065,74,48280,54507,102787,88.5758
Portugal,2065,75,47080,53549,100629,87.9195
Portugal,2065,76,46682,53963,100645,86.5074
Portugal,2065,77,45535,53690,99225,84.811
Portugal,2065,78,44976,54213,99189,82.9617
Portugal,2065,79,44937,55019,99956,81.6754
Portugal,2065,80,46461,58231,104692,79.7874
Portugal,2065,81,45804,58590,104394,78.1772
Portugal,2065,82,45834,60455,106289,75.8151
Portugal,2065,83,44026,59726,103752,73.7133
Portugal,2065,84,43763,60540,104303,72.2877
Portugal,2065,85,41226,58263,99489,70.7585
Portugal,2065,86,39316,57549,96865,68.3174
Portugal,2065,87,39264,58587,97851,67.0183
Portugal,2065,88,36197,56206,92403,64.4006
Portugal,2065,89,32330,51646,83976,62.5992
Portugal,2065,90,27443,46431,73874,59.1049
Portugal,2065,91,22760,40051,62811,56.8275
Portugal,2065,92,19049,35134,54183,54.2181
Portugal,2065,93,15564,29938,45502,51.9874
Portugal,2065,94,12144,24384,36528,49.8031
Portugal,2065,95,9181,19489,28670,47.1086
Portugal,2065,96,6807,15325,22132,44.4176
Portugal,2065,97,4855,11809,16664,41.1127
Portugal,2065,98,3415,8799,12214,38.8112
Portugal,2065,99,2295,6268,8563,36.6146
Portugal,2065,100,3451,10818,14269,31.9005
Portugal,2066,0,31988,30092,62080,106.3007
Portugal,2066,1,32208,30307,62515,106.2725
Portugal,2066,2,32342,30436,62778,106.2623
Portugal,2066,3,32452,30542,62994,106.2537
Portugal,2066,4,32751,30826,63577,106.2447
Portugal,2066,5,32799,30872,63671,106.2419
Portugal,2066,6,32877,30951,63828,106.2227
Portugal,2066,7,33148,31208,64356,106.2164
Portugal,2066,8,33326,31372,64698,106.2285
Portugal,2066,9,33565,31603,65168,106.2083
Portugal,2066,10,33760,31789,65549,106.2003
Portugal,2066,11,33983,32000,65983,106.1969
Portugal,2066,12,34307,32306,66613,106.1939
Portugal,2066,13,34623,32607,67230,106.1827
Portugal,2066,14,34994,32966,67960,106.1518
Portugal,2066,15,35383,33348,68731,106.1023
Portugal,2066,16,35978,33917,69895,106.0766
Portugal,2066,17,36451,34384,70835,106.0115
Portugal,2066,18,36870,34801,71671,105.9452
Portugal,2066,19,37441,35367,72808,105.8642
Portugal,2066,20,37857,35791,73648,105.7724
Portugal,2066,21,38416,36349,74765,105.6865
Portugal,2066,22,39061,36980,76041,105.6274
Portugal,2066,23,39790,37698,77488,105.5494
Portugal,2066,24,40325,38229,78554,105.4827
Portugal,2066,25,40816,38723,79539,105.4051
Portugal,2066,26,41372,39272,80644,105.3473
Portugal,2066,27,41815,39716,81531,105.285
Portugal,2066,28,42066,39980,82046,105.2176
Portugal,2066,29,42558,40466,83024,105.1698
Portugal,2066,30,42982,40883,83865,105.1342
Portugal,2066,31,43245,41155,84400,105.0784
Portugal,2066,32,43431,41349,84780,105.0352
Portugal,2066,33,43378,41321,84699,104.9781
Portugal,2066,34,43622,41573,85195,104.9287
Portugal,2066,35,43656,41638,85294,104.8465
Portugal,2066,36,43690,41692,85382,104.7923
Portugal,2066,37,43805,41833,85638,104.714
Portugal,2066,38,43840,41901,85741,104.6276
Portugal,2066,39,43951,42040,85991,104.5457
Portugal,2066,40,44001,42133,86134,104.4336
Portugal,2066,41,44294,42460,86754,104.3194
Portugal,2066,42,44554,42765,87319,104.1833
Portugal,2066,43,44824,43092,87916,104.0193
Portugal,2066,44,45152,43485,88637,103.8335
Portugal,2066,45,47254,45451,92705,103.9669
Portugal,2066,46,48508,46680,95188,103.916
Portugal,2066,47,48237,47432,95669,101.6972
Portugal,2066,48,48103,47053,95156,102.2315
Portugal,2066,49,48808,47290,96098,103.21
Portugal,2066,50,47778,46835,94613,102.0135
Portugal,2066,51,46444,44853,91297,103.5471
Portugal,2066,52,46108,45342,91450,101.6894
Portugal,2066,53,49694,48163,97857,103.1788
Portugal,2066,54,52358,51072,103430,102.518
Portugal,2066,55,53383,53453,106836,99.869
Portugal,2066,56,51708,51361,103069,100.6756
Portugal,2066,57,53771,52896,106667,101.6542
Portugal,2066,58,52462,52096,104558,100.7025
Portugal,2066,59,53316,53533,106849,99.5946
Portugal,2066,60,55405,54919,110324,100.8849
Portugal,2066,61,53997,54408,108405,99.2446
Portugal,2066,62,55002,55411,110413,99.2619
Portugal,2066,63,55195,55625,110820,99.227
Portugal,2066,64,54620,55318,109938,98.7382
Portugal,2066,65,58223,59547,117770,97.7765
Portugal,2066,66,56133,58292,114425,96.2962
Portugal,2066,67,53947,56176,110123,96.0321
Portugal,2066,68,52577,55741,108318,94.3237
Portugal,2066,69,51730,54012,105742,95.775
Portugal,2066,70,50179,53079,103258,94.5364
Portugal,2066,71,48776,52581,101357,92.7635
Portugal,2066,72,49275,54506,103781,90.4029
Portugal,2066,73,48567,54524,103091,89.0745
Portugal,2066,74,48720,54609,103329,89.2161
Portugal,2066,75,47719,54226,101945,88.0002
Portugal,2066,76,46473,53235,99708,87.2978
Portugal,2066,77,45998,53590,99588,85.8332
Portugal,2066,78,44782,53256,98038,84.0882
Portugal,2066,79,44117,53685,97802,82.1775
Portugal,2066,80,43929,54364,98293,80.8053
Portugal,2066,81,45196,57357,102553,78.7977
Portugal,2066,82,44330,57526,101856,77.0608
Portugal,2066,83,44134,59163,103297,74.5973
Portugal,2066,84,42121,58194,100315,72.3803
Portugal,2066,85,41533,58638,100171,70.8295
Portugal,2066,86,38698,55951,94649,69.1641
Portugal,2066,87,36457,54724,91181,66.6198
Portugal,2066,88,35936,55160,91096,65.1487
Portugal,2066,89,32509,52188,84697,62.2921
Portugal,2066,90,28477,47231,75708,60.293
Portugal,2066,91,23714,41740,65454,56.8136
Portugal,2066,92,19314,35433,54747,54.5085
Portugal,2066,93,15927,30707,46634,51.8677
Portugal,2066,94,12694,25641,38335,49.5066
Portugal,2066,95,9581,20297,29878,47.204
Portugal,2066,96,6987,15695,22682,44.5174
Portugal,2066,97,5003,11931,16934,41.9328
Portugal,2066,98,3442,8875,12317,38.7831
Portugal,2066,99,2327,6366,8693,36.5536
Portugal,2066,100,3557,11133,14690,31.9501
Portugal,2067,0,31904,30015,61919,106.2935
Portugal,2067,1,32051,30156,62207,106.284
Portugal,2067,2,32264,30363,62627,106.2609
Portugal,2067,3,32391,30485,62876,106.2523
Portugal,2067,4,32493,30583,63076,106.2453
Portugal,2067,5,32786,30861,63647,106.2376
Portugal,2067,6,32829,30902,63731,106.2358
Portugal,2067,7,32903,30976,63879,106.2209
Portugal,2067,8,33170,31229,64399,106.2154
Portugal,2067,9,33345,31391,64736,106.2247
Portugal,2067,10,33581,31619,65200,106.2051
Portugal,2067,11,33776,31806,65582,106.1938
Portugal,2067,12,34003,32021,66024,106.1897
Portugal,2067,13,34334,32336,66670,106.1789
Portugal,2067,14,34662,32652,67314,106.1558
Portugal,2067,15,35051,33031,68082,106.1155
Portugal,2067,16,35461,33437,68898,106.0532
Portugal,2067,17,36079,34031,70110,106.018
Portugal,2067,18,36574,34523,71097,105.941
Portugal,2067,19,37015,34963,71978,105.8691
Portugal,2067,20,37602,35546,73148,105.7841
Portugal,2067,21,38031,35984,74015,105.6886
Portugal,2067,22,38600,36550,75150,105.6088
Portugal,2067,23,39249,37184,76433,105.5535
Portugal,2067,24,39979,37903,77882,105.4771
Portugal,2067,25,40511,38429,78940,105.4178
Portugal,2067,26,40997,38917,79914,105.3447
Portugal,2067,27,41546,39458,81004,105.2917
Portugal,2067,28,41980,39892,81872,105.2341
Portugal,2067,29,42222,40145,82367,105.1737
Portugal,2067,30,42704,40620,83324,105.1305
Portugal,2067,31,43118,41026,84144,105.0992
Portugal,2067,32,43371,41287,84658,105.0476
Portugal,2067,33,43548,41470,85018,105.0109
Portugal,2067,34,43483,41432,84915,104.9503
Portugal,2067,35,43717,41674,85391,104.9023
Portugal,2067,36,43742,41730,85472,104.8215
Portugal,2067,37,43768,41775,85543,104.7708
Portugal,2067,38,43874,41907,85781,104.6937
Portugal,2067,39,43898,41966,85864,104.6037
Portugal,2067,40,43999,42098,86097,104.5157
Portugal,2067,41,44039,42183,86222,104.3999
Portugal,2067,42,44323,42503,86826,104.2821
Portugal,2067,43,44574,42802,87376,104.14
Portugal,2067,44,44834,43123,87957,103.9677
Portugal,2067,45,45152,43510,88662,103.7738
Portugal,2067,46,47241,45468,92709,103.8994
Portugal,2067,47,48480,46690,95170,103.8338
Portugal,2067,48,48198,47435,95633,101.6085
Portugal,2067,49,48053,47050,95103,102.1318
Portugal,2067,50,48744,47282,96026,103.0921
Portugal,2067,51,47700,46821,94521,101.8774
Portugal,2067,52,46354,44834,91188,103.3903
Portugal,2067,53,46005,45317,91322,101.5182
Portugal,2067,54,49570,48131,97701,102.9898
Portugal,2067,55,52213,51033,103246,102.3122
Portugal,2067,56,53220,53406,106626,99.6517
Portugal,2067,57,51534,51310,102844,100.4366
Portugal,2067,58,53572,52839,106411,101.3872
Portugal,2067,59,52249,52032,104281,100.4171
Portugal,2067,60,53078,53457,106535,99.291
Portugal,2067,61,55133,54832,109965,100.5489
Portugal,2067,62,53721,54319,108040,98.8991
Portugal,2067,63,54717,55319,110036,98.9118
Portugal,2067,64,54902,55527,110429,98.8744
Portugal,2067,65,54323,55215,109538,98.3845
Portugal,2067,66,57894,59428,117322,97.4187
Portugal,2067,67,55796,58167,113963,95.9238
Portugal,2067,68,53600,56046,109646,95.6357
Portugal,2067,69,52203,55592,107795,93.9038
Portugal,2067,70,51339,53855,105194,95.3282
Portugal,2067,71,49771,52908,102679,94.0708
Portugal,2067,72,48343,52392,100735,92.2717
Portugal,2067,73,48808,54291,103099,89.9007
Portugal,2067,74,48060,54281,102341,88.5393
Portugal,2067,75,48167,54337,102504,88.6449
Portugal,2067,76,47117,53918,101035,87.3864
Portugal,2067,77,45806,52879,98685,86.6242
Portugal,2067,78,45253,53171,98424,85.1084
Portugal,2067,79,43944,52753,96697,83.3014
Portugal,2067,80,43147,53065,96212,81.3097
Portugal,2067,81,42754,53570,96324,79.8096
Portugal,2067,82,43764,56341,100105,77.677
Portugal,2067,83,42712,56325,99037,75.8313
Portugal,2067,84,42254,57680,99934,73.2559
Portugal,2067,85,40006,56406,96412,70.9251
Portugal,2067,86,39020,56357,95377,69.2372
Portugal,2067,87,35917,53254,89171,67.4447
Portugal,2067,88,33401,51576,84977,64.7607
Portugal,2067,89,32310,51275,83585,63.0132
Portugal,2067,90,28669,47785,76454,59.9958
Portugal,2067,91,24637,42515,67152,57.949
Portugal,2067,92,20149,36979,57128,54.4877
Portugal,2067,93,16170,31016,47186,52.1344
Portugal,2067,94,13008,26342,39350,49.3812
Portugal,2067,95,10030,21379,31409,46.9152
Portugal,2067,96,7301,16373,23674,44.5917
Portugal,2067,97,5142,12239,17381,42.0132
Portugal,2067,98,3551,8982,12533,39.5346
Portugal,2067,99,2348,6431,8779,36.5107
Portugal,2067,100,3644,11409,15053,31.9397
Portugal,2068,0,31919,30024,61943,106.3116
Portugal,2068,1,31967,30080,62047,106.2733
Portugal,2068,2,32107,30213,62320,106.2688
Portugal,2068,3,32312,30412,62724,106.2475
Portugal,2068,4,32432,30526,62958,106.2439
Portugal,2068,5,32528,30618,63146,106.2382
Portugal,2068,6,32815,30890,63705,106.2318
Portugal,2068,7,32854,30927,63781,106.2308
Portugal,2068,8,32925,30997,63922,106.22
Portugal,2068,9,33188,31248,64436,106.2084
Portugal,2068,10,33361,31408,64769,106.2182
Portugal,2068,11,33598,31637,65235,106.1984
Portugal,2068,12,33795,31827,65622,106.1834
Portugal,2068,13,34030,32051,66081,106.1745
Portugal,2068,14,34373,32380,66753,106.155
Portugal,2068,15,34719,32716,67435,106.1224
Portugal,2068,16,35129,33119,68248,106.069
Portugal,2068,17,35562,33551,69113,105.9939
Portugal,2068,18,36203,34170,70373,105.9497
Portugal,2068,19,36719,34684,71403,105.8673
Portugal,2068,20,37176,35142,72318,105.7879
Portugal,2068,21,37777,35739,73516,105.7025
Portugal,2068,22,38215,36185,74400,105.6101
Portugal,2068,23,38788,36755,75543,105.5312
Portugal,2068,24,39438,37389,76827,105.4802
Portugal,2068,25,40166,38103,78269,105.4143
Portugal,2068,26,40693,38624,79317,105.3568
Portugal,2068,27,41171,39103,80274,105.2886
Portugal,2068,28,41711,39634,81345,105.2405
Portugal,2068,29,42136,40057,82193,105.1901
Portugal,2068,30,42368,40298,82666,105.1367
Portugal,2068,31,42840,40763,83603,105.0953
Portugal,2068,32,43245,41158,84403,105.0707
Portugal,2068,33,43488,41408,84896,105.0232
Portugal,2068,34,43653,41581,85234,104.983
Portugal,2068,35,43578,41532,85110,104.9263
Portugal,2068,36,43804,41766,85570,104.8796
Portugal,2068,37,43820,41813,85633,104.7999
Portugal,2068,38,43837,41849,85686,104.7504
Portugal,2068,39,43933,41973,85906,104.6697
Portugal,2068,40,43947,42024,85971,104.576
Portugal,2068,41,44038,42148,86186,104.4842
Portugal,2068,42,44069,42226,86295,104.3646
Portugal,2068,43,44343,42540,86883,104.2384
Portugal,2068,44,44584,42833,87417,104.088
Portugal,2068,45,44835,43148,87983,103.9098
Portugal,2068,46,45141,43528,88669,103.7057
Portugal,2068,47,47215,45479,92694,103.8171
Portugal,2068,48,48442,46694,95136,103.7435
Portugal,2068,49,48148,47433,95581,101.5074
Portugal,2068,50,47990,47043,95033,102.0131
Portugal,2068,51,48665,47268,95933,102.9555
Portugal,2068,52,47607,46802,94409,101.72
Portugal,2068,53,46252,44811,91063,103.2157
Portugal,2068,54,45893,45289,91182,101.3337
Portugal,2068,55,49436,48097,97533,102.784
Portugal,2068,56,52056,50989,103045,102.0926
Portugal,2068,57,53042,53353,106395,99.4171
Portugal,2068,58,51347,51256,102603,100.1775
Portugal,2068,59,53357,52775,106132,101.1028
Portugal,2068,60,52019,51961,103980,100.1116
Portugal,2068,61,52822,53375,106197,98.9639
Portugal,2068,62,54855,54744,109599,100.2028
Portugal,2068,63,53448,54231,107679,98.5562
Portugal,2068,64,54431,55224,109655,98.564
Portugal,2068,65,54608,55426,110034,98.5242
Portugal,2068,66,54021,55109,109130,98.0257
Portugal,2068,67,57552,59305,116857,97.0441
Portugal,2068,68,55443,58036,113479,95.5321
Portugal,2068,69,53225,55900,109125,95.2147
Portugal,2068,70,51817,55435,107252,93.4734
Portugal,2068,71,50929,53686,104615,94.8646
Portugal,2068,72,49338,52723,102061,93.5797
Portugal,2068,73,47894,52192,100086,91.765
Portugal,2068,74,48308,54057,102365,89.3649
Portugal,2068,75,47525,54019,101544,87.9783
Portugal,2068,76,47571,54039,101610,88.0309
Portugal,2068,77,46454,53569,100023,86.7181
Portugal,2068,78,45079,52478,97557,85.9008
Portugal,2068,79,44422,52684,97106,84.3178
Portugal,2068,80,42994,52161,95155,82.4256
Portugal,2068,81,42011,52309,94320,80.3131
Portugal,2068,82,41420,52644,94064,78.6794
Portugal,2068,83,42190,55193,97383,76.4409
Portugal,2068,84,40917,54946,95863,74.4677
Portugal,2068,85,40160,55945,96105,71.7848
Portugal,2068,86,37614,54255,91869,69.3282
Portugal,2068,87,36245,53688,89933,67.5104
Portugal,2068,88,32936,50241,83177,65.556
Portugal,2068,89,30061,47996,78057,62.6323
Portugal,2068,90,28523,47006,75529,60.6795
Portugal,2068,91,24830,43070,67900,57.6503
Portugal,2068,92,20957,37717,58674,55.5638
Portugal,2068,93,16890,32417,49307,52.1023
Portugal,2068,94,13224,26649,39873,49.6229
Portugal,2068,95,10291,21999,32290,46.7794
Portugal,2068,96,7653,17273,24926,44.3061
Portugal,2068,97,5380,12788,18168,42.0707
Portugal,2068,98,3654,9228,12882,39.5969
Portugal,2068,99,2425,6518,8943,37.2047
Portugal,2068,100,3711,11637,15348,31.8897
Portugal,2069,0,31818,29931,61749,106.3045
Portugal,2069,1,31982,30089,62071,106.2913
Portugal,2069,2,32023,30137,62160,106.2581
Portugal,2069,3,32156,30262,62418,106.2587
Portugal,2069,4,32353,30453,62806,106.2391
Portugal,2069,5,32466,30561,63027,106.2334
Portugal,2069,6,32557,30648,63205,106.2288
Portugal,2069,7,32841,30916,63757,106.2265
Portugal,2069,8,32876,30949,63825,106.2264
Portugal,2069,9,32943,31016,63959,106.2129
Portugal,2069,10,33205,31265,64470,106.205
Portugal,2069,11,33377,31425,64802,106.2116
Portugal,2069,12,33617,31658,65275,106.188
Portugal,2069,13,33822,31857,65679,106.1682
Portugal,2069,14,34069,32095,66164,106.1505
Portugal,2069,15,34430,32445,66875,106.118
Portugal,2069,16,34797,32805,67602,106.0722
Portugal,2069,17,35230,33233,68463,106.0091
Portugal,2069,18,35686,33690,69376,105.9246
Portugal,2069,19,36348,34332,70680,105.8721
Portugal,2069,20,36880,34864,71744,105.7825
Portugal,2069,21,37350,35335,72685,105.7026
Portugal,2069,22,37961,35941,73902,105.6203
Portugal,2069,23,38404,36390,74794,105.5345
Portugal,2069,24,38977,36959,75936,105.4601
Portugal,2069,25,39625,37589,77214,105.4165
Portugal,2069,26,40348,38298,78646,105.3528
Portugal,2069,27,40867,38810,79677,105.3002
Portugal,2069,28,41337,39279,80616,105.2394
Portugal,2069,29,41867,39799,81666,105.1961
Portugal,2069,30,42282,40211,82493,105.1503
Portugal,2069,31,42504,40441,82945,105.1013
Portugal,2069,32,42967,40895,83862,105.0666
Portugal,2069,33,43362,41279,84641,105.0461
Portugal,2069,34,43593,41519,85112,104.9953
Portugal,2069,35,43748,41682,85430,104.9566
Portugal,2069,36,43665,41624,85289,104.9034
Portugal,2069,37,43882,41849,85731,104.8579
Portugal,2069,38,43890,41888,85778,104.7794
Portugal,2069,39,43897,41915,85812,104.7286
Portugal,2069,40,43982,42032,86014,104.6393
Portugal,2069,41,43987,42075,86062,104.5443
Portugal,2069,42,44068,42192,86260,104.4463
Portugal,2069,43,44090,42264,86354,104.3205
Portugal,2069,44,44355,42572,86927,104.1882
Portugal,2069,45,44586,42858,87444,104.0319
Portugal,2069,46,44826,43167,87993,103.8432
Portugal,2069,47,45120,43541,88661,103.6265
Portugal,2069,48,47180,45485,92665,103.7265
Portugal,2069,49,48392,46693,95085,103.6387
Portugal,2069,50,48087,47426,95513,101.3938
Portugal,2069,51,47915,47030,94945,101.8818
Portugal,2069,52,48572,47250,95822,102.7979
Portugal,2069,53,47504,46778,94282,101.552
Portugal,2069,54,46141,44785,90926,103.0278
Portugal,2069,55,45773,45259,91032,101.1357
Portugal,2069,56,49290,48058,97348,102.5636
Portugal,2069,57,51885,50941,102826,101.8531
Portugal,2069,58,52852,53298,106150,99.1632
Portugal,2069,59,51145,51196,102341,99.9004
Portugal,2069,60,53126,52705,105831,100.7988
Portugal,2069,61,51772,51883,103655,99.7861
Portugal,2069,62,52560,53291,105851,98.6283
Portugal,2069,63,54580,54658,109238,99.8573
Portugal,2069,64,53173,54141,107314,98.2121
Portugal,2069,65,54145,55126,109271,98.2204
Portugal,2069,66,54311,55323,109634,98.1707
Portugal,2069,67,53709,54998,108707,97.6563
Portugal,2069,68,57195,59175,116370,96.654
Portugal,2069,69,55063,57889,112952,95.1182
Portugal,2069,70,52839,55747,108586,94.7836
Portugal,2069,71,51411,55266,106677,93.0246
Portugal,2069,72,50495,53504,103999,94.3761
Portugal,2069,73,48889,52528,101417,93.0723
Portugal,2069,74,47413,51973,99386,91.2262
Portugal,2069,75,47780,53804,101584,88.8038
Portugal,2069,76,46949,53731,100680,87.3779
Portugal,2069,77,46914,53698,100612,87.3664
Portugal,2069,78,45730,53174,98904,86.0007
Portugal,2069,79,44266,52010,96276,85.1106
Portugal,2069,80,43478,52107,95585,83.4398
Portugal,2069,81,41880,51435,93315,81.4232
Portugal,2069,82,40720,51425,92145,79.1833
Portugal,2069,83,39952,51594,91546,77.4354
Portugal,2069,84,40442,53869,94311,75.0747
Portugal,2069,85,38916,53325,92241,72.9789
Portugal,2069,86,37786,53848,91634,70.1716
Portugal,2069,87,34968,51725,86693,67.6037
Portugal,2069,88,33268,50695,83963,65.6238
Portugal,2069,89,29671,46799,76470,63.4009
Portugal,2069,90,26566,44047,70613,60.3128
Portugal,2069,91,24731,42414,67145,58.3086
Portugal,2069,92,21145,38255,59400,55.2738
Portugal,2069,93,17589,33108,50697,53.1261
Portugal,2069,94,13830,27891,41721,49.5859
Portugal,2069,95,10475,22286,32761,47.0026
Portugal,2069,96,7862,17799,25661,44.171
Portugal,2069,97,5646,13511,19157,41.7882
Portugal,2069,98,3828,9656,13484,39.6437
Portugal,2069,99,2499,6706,9205,37.2651
Portugal,2069,100,3804,11847,15651,32.1094
Portugal,2070,0,31697,29816,61513,106.3087
Portugal,2070,1,31881,29996,61877,106.2842
Portugal,2070,2,32038,30145,62183,106.2796
Portugal,2070,3,32071,30185,62256,106.2481
Portugal,2070,4,32197,30303,62500,106.2502
Portugal,2070,5,32388,30488,62876,106.232
Portugal,2070,6,32496,30591,63087,106.2273
Portugal,2070,7,32583,30673,63256,106.227
Portugal,2070,8,32862,30937,63799,106.2223
Portugal,2070,9,32894,30967,63861,106.2228
Portugal,2070,10,32959,31033,63992,106.2063
Portugal,2070,11,33221,31282,64503,106.1985
Portugal,2070,12,33397,31446,64843,106.2043
Portugal,2070,13,33644,31687,65331,106.176
Portugal,2070,14,33862,31901,65763,106.1471
Portugal,2070,15,34126,32159,66285,106.1165
Portugal,2070,16,34508,32533,67041,106.0708
Portugal,2070,17,34898,32919,67817,106.0117
Portugal,2070,18,35354,33373,68727,105.9359
Portugal,2070,19,35830,33852,69682,105.8431
Portugal,2070,20,36509,34512,71021,105.7864
Portugal,2070,21,37055,35057,72112,105.6993
Portugal,2070,22,37535,35537,73072,105.6223
Portugal,2070,23,38149,36146,74295,105.5414
Portugal,2070,24,38593,36594,75187,105.4626
Portugal,2070,25,39164,37160,76324,105.3929
Portugal,2070,26,39807,37784,77591,105.3541
Portugal,2070,27,40522,38484,79006,105.2957
Portugal,2070,28,41033,38986,80019,105.2506
Portugal,2070,29,41493,39444,80937,105.1947
Portugal,2070,30,42014,39953,81967,105.1586
Portugal,2070,31,42418,40354,82772,105.1147
Portugal,2070,32,42631,40573,83204,105.0723
Portugal,2070,33,43084,41016,84100,105.0419
Portugal,2070,34,43468,41390,84858,105.0205
Portugal,2070,35,43689,41620,85309,104.9712
Portugal,2070,36,43835,41774,85609,104.9337
Portugal,2070,37,43744,41708,85452,104.8816
Portugal,2070,38,43952,41923,85875,104.8398
Portugal,2070,39,43949,41954,85903,104.7552
Portugal,2070,40,43946,41974,85920,104.6981
Portugal,2070,41,44022,42083,86105,104.6076
Portugal,2070,42,44017,42119,86136,104.5063
Portugal,2070,43,44090,42230,86320,104.4045
Portugal,2070,44,44102,42296,86398,104.2699
Portugal,2070,45,44358,42598,86956,104.1316
Portugal,2070,46,44578,42878,87456,103.9647
Portugal,2070,47,44806,43180,87986,103.7656
Portugal,2070,48,45089,43548,88637,103.5386
Portugal,2070,49,47134,45485,92619,103.6254
Portugal,2070,50,48333,46687,95020,103.5256
Portugal,2070,51,48013,47414,95427,101.2633
Portugal,2070,52,47825,47013,94838,101.7272
Portugal,2070,53,48468,47226,95694,102.6299
Portugal,2070,54,47392,46751,94143,101.3711
Portugal,2070,55,46022,44756,90778,102.8287
Portugal,2070,56,45642,45224,90866,100.9243
Portugal,2070,57,49133,48015,97148,102.3284
Portugal,2070,58,51703,50891,102594,101.5956
Portugal,2070,59,52648,53238,105886,98.8918
Portugal,2070,60,50927,51130,102057,99.603
Portugal,2070,61,52878,52628,105506,100.475
Portugal,2070,62,51520,51804,103324,99.4518
Portugal,2070,63,52303,53210,105513,98.2954
Portugal,2070,64,54306,54569,108875,99.518
Portugal,2070,65,52900,54048,106948,97.876
Portugal,2070,66,53857,55026,108883,97.8755
Portugal,2070,67,54003,55215,109218,97.8049
Portugal,2070,68,53384,54881,108265,97.2723
Portugal,2070,69,56811,59030,115841,96.2409
Portugal,2070,70,54672,57734,112406,94.6964
Portugal,2070,71,52434,55582,108016,94.3363
Portugal,2070,72,50982,55084,106066,92.5532
Portugal,2070,73,50045,53311,103356,93.8737
Portugal,2070,74,48409,52314,100723,92.5355
Portugal,2070,75,46908,51737,98645,90.6663
Portugal,2070,76,47215,53525,100740,88.2111
Portugal,2070,77,46315,53402,99717,86.729
Portugal,2070,78,46200,53313,99513,86.658
Portugal,2070,79,44924,52712,97636,85.2254
Portugal,2070,80,43345,51455,94800,84.2387
Portugal,2070,81,42373,51399,93772,82.4393
Portugal,2070,82,40617,50585,91202,80.2946
Portugal,2070,83,39302,50421,89723,77.9477
Portugal,2070,84,38325,50381,88706,76.0703
Portugal,2070,85,38496,52310,90806,73.592
Portugal,2070,86,36649,51361,88010,71.3557
Portugal,2070,87,35163,51377,86540,68.4411
Portugal,2070,88,32130,48884,81014,65.727
Portugal,2070,89,30005,47267,77272,63.4798
Portugal,2070,90,26254,42993,69247,61.0658
Portugal,2070,91,23063,39788,62851,57.9647
Portugal,2070,92,21088,37718,58806,55.9096
Portugal,2070,93,17773,33624,51397,52.8581
Portugal,2070,94,14424,28524,42948,50.5679
Portugal,2070,95,10972,23358,34330,46.9732
Portugal,2070,96,8015,18057,26072,44.3872
Portugal,2070,97,5809,13942,19751,41.6655
Portugal,2070,98,4023,10215,14238,39.3833
Portugal,2070,99,2621,7026,9647,37.3043
Portugal,2070,100,3912,12119,16031,32.2799
Portugal,2071,0,31526,29657,61183,106.3021
Portugal,2071,1,31760,29881,61641,106.2883
Portugal,2071,2,31937,30053,61990,106.2689
Portugal,2071,3,32086,30194,62280,106.2661
Portugal,2071,4,32112,30226,62338,106.2397
Portugal,2071,5,32231,30338,62569,106.2397
Portugal,2071,6,32417,30518,62935,106.2226
Portugal,2071,7,32521,30616,63137,106.2222
Portugal,2071,8,32604,30694,63298,106.2227
Portugal,2071,9,32881,30956,63837,106.2185
Portugal,2071,10,32911,30984,63895,106.2193
Portugal,2071,11,32976,31050,64026,106.2029
Portugal,2071,12,33240,31303,64543,106.1879
Portugal,2071,13,33424,31475,64899,106.1922
Portugal,2071,14,33684,31732,65416,106.1515
Portugal,2071,15,33919,31966,65885,106.1096
Portugal,2071,16,34204,32248,66452,106.0655
Portugal,2071,17,34609,32647,67256,106.0097
Portugal,2071,18,35022,33058,68080,105.9411
Portugal,2071,19,35499,33535,69034,105.8566
Portugal,2071,20,35992,34032,70024,105.7593
Portugal,2071,21,36684,34705,71389,105.7023
Portugal,2071,22,37239,35259,72498,105.6156
Portugal,2071,23,37723,35741,73464,105.5455
Portugal,2071,24,38339,36350,74689,105.4718
Portugal,2071,25,38780,36795,75575,105.3948
Portugal,2071,26,39346,37355,76701,105.3299
Portugal,2071,27,39982,37970,77952,105.2989
Portugal,2071,28,40688,38660,79348,105.2457
Portugal,2071,29,41189,39151,80340,105.2055
Portugal,2071,30,41639,39599,81238,105.1516
Portugal,2071,31,42150,40096,82246,105.1227
Portugal,2071,32,42546,40486,83032,105.0882
Portugal,2071,33,42749,40695,83444,105.0473
Portugal,2071,34,43190,41127,84317,105.0162
Portugal,2071,35,43563,41491,85054,104.9939
Portugal,2071,36,43776,41712,85488,104.9482
Portugal,2071,37,43914,41857,85771,104.9144
Portugal,2071,38,43814,41783,85597,104.8608
Portugal,2071,39,44012,41990,86002,104.8154
Portugal,2071,40,43999,42013,86012,104.7271
Portugal,2071,41,43986,42025,86011,104.6663
Portugal,2071,42,44053,42127,86180,104.5719
Portugal,2071,43,44039,42157,86196,104.4643
Portugal,2071,44,44103,42262,86365,104.3562
Portugal,2071,45,44106,42322,86428,104.2153
Portugal,2071,46,44350,42618,86968,104.064
Portugal,2071,47,44559,42892,87451,103.8865
Portugal,2071,48,44776,43188,87964,103.6769
Portugal,2071,49,45048,43550,88598,103.4397
Portugal,2071,50,47078,45481,92559,103.5114
Portugal,2071,51,48259,46676,94935,103.3915
Portugal,2071,52,47925,47397,95322,101.114
Portugal,2071,53,47725,46990,94715,101.5642
Portugal,2071,54,48355,47199,95554,102.4492
Portugal,2071,55,47271,46721,93992,101.1772
Portugal,2071,56,45893,44723,90616,102.6161
Portugal,2071,57,45500,45186,90686,100.6949
Portugal,2071,58,48964,47969,96933,102.0743
Portugal,2071,59,51506,50835,102341,101.32
Portugal,2071,60,52427,53170,105597,98.6026
Portugal,2071,61,50693,51057,101750,99.2871
Portugal,2071,62,52624,52549,105173,100.1427
Portugal,2071,63,51272,51727,102999,99.1204
Portugal,2071,64,52045,53126,105171,97.9652
Portugal,2071,65,54031,54478,108509,99.1795
Portugal,2071,66,52624,53952,106576,97.5386
Portugal,2071,67,53558,54922,108480,97.5165
Portugal,2071,68,53682,55101,108783,97.4247
Portugal,2071,69,53033,54751,107784,96.8622
Portugal,2071,70,56415,58876,115291,95.82
Portugal,2071,71,54261,57569,111830,94.2539
Portugal,2071,72,52005,55404,107409,93.8651
Portugal,2071,73,50537,54892,105429,92.0662
Portugal,2071,74,49564,53101,102665,93.3391
Portugal,2071,75,47904,52084,99988,91.9745
Portugal,2071,76,46364,51478,97842,90.0657
Portugal,2071,77,46590,53207,99797,87.5637
Portugal,2071,78,45624,53031,98655,86.0327
Portugal,2071,79,45400,52865,98265,85.8791
Portugal,2071,80,44006,52166,96172,84.3576
Portugal,2071,81,42261,50774,93035,83.2335
Portugal,2071,82,41114,50570,91684,81.3012
Portugal,2071,83,39223,49621,88844,79.0452
Portugal,2071,84,37724,49263,86987,76.5767
Portugal,2071,85,36505,48955,85460,74.5685
Portugal,2071,86,36280,50421,86701,71.9541
Portugal,2071,87,34133,49046,83179,69.5939
Portugal,2071,88,32338,48603,80941,66.535
Portugal,2071,89,29007,45627,74634,63.5742
Portugal,2071,90,26577,43474,70051,61.1331
Portugal,2071,91,22818,38885,61703,58.6807
Portugal,2071,92,19688,35430,55118,55.5687
Portugal,2071,93,17747,33201,50948,53.4532
Portugal,2071,94,14593,29014,43607,50.2964
Portugal,2071,95,11458,23927,35385,47.8873
Portugal,2071,96,8405,18956,27361,44.3395
Portugal,2071,97,5929,14167,20096,41.8508
Portugal,2071,98,4144,10558,14702,39.2499
Portugal,2071,99,2757,7444,10201,37.0365
Portugal,2071,100,4060,12529,16589,32.4048
Portugal,2072,0,31427,29566,60993,106.2944
Portugal,2072,1,31590,29723,61313,106.2813
Portugal,2072,2,31817,29938,61755,106.2763
Portugal,2072,3,31985,30101,62086,106.2589
Portugal,2072,4,32127,30235,62362,106.2576
Portugal,2072,5,32147,30261,62408,106.2324
Portugal,2072,6,32261,30368,62629,106.2335
Portugal,2072,7,32443,30543,62986,106.2207
Portugal,2072,8,32543,30638,63181,106.2178
Portugal,2072,9,32623,30713,63336,106.2189
Portugal,2072,10,32897,30973,63870,106.2119
Portugal,2072,11,32927,31001,63928,106.2127
Portugal,2072,12,32995,31071,64066,106.1923
Portugal,2072,13,33267,31332,64599,106.1758
Portugal,2072,14,33463,31520,64983,106.1643
Portugal,2072,15,33741,31796,65537,106.1171
Portugal,2072,16,33997,32054,66051,106.0616
Portugal,2072,17,34306,32362,66668,106.007
Portugal,2072,18,34734,32787,67521,105.9383
Portugal,2072,19,35167,33220,68387,105.8609
Portugal,2072,20,35661,33714,69375,105.775
Portugal,2072,21,36167,34225,70392,105.6742
Portugal,2072,22,36869,34906,71775,105.6237
Portugal,2072,23,37428,35464,72892,105.538
Portugal,2072,24,37913,35946,73859,105.4721
Portugal,2072,25,38526,36551,75077,105.4034
Portugal,2072,26,38963,36990,75953,105.3339
Portugal,2072,27,39521,37541,77062,105.2742
Portugal,2072,28,40148,38147,78295,105.2455
Portugal,2072,29,40845,38826,79671,105.2001
Portugal,2072,30,41336,39306,80642,105.1646
Portugal,2072,31,41776,39742,81518,105.118
Portugal,2072,32,42278,40229,82507,105.0933
Portugal,2072,33,42663,40608,83271,105.0606
Portugal,2072,34,42855,40806,83661,105.0213
Portugal,2072,35,43286,41228,84514,104.9918
Portugal,2072,36,43651,41584,85235,104.9707
Portugal,2072,37,43855,41796,85651,104.9263
Portugal,2072,38,43984,41932,85916,104.8936
Portugal,2072,39,43874,41849,85723,104.8388
Portugal,2072,40,44062,42049,86111,104.7873
Portugal,2072,41,44040,42064,86104,104.6976
Portugal,2072,42,44018,42070,86088,104.6304
Portugal,2072,43,44076,42165,86241,104.5322
Portugal,2072,44,44053,42190,86243,104.4157
Portugal,2072,45,44107,42289,86396,104.299
Portugal,2072,46,44100,42343,86443,104.1494
Portugal,2072,47,44333,42632,86965,103.99
Portugal,2072,48,44531,42901,87432,103.7994
Portugal,2072,49,44737,43191,87928,103.5794
Portugal,2072,50,44997,43548,88545,103.3274
Portugal,2072,51,47009,45472,92481,103.3801
Portugal,2072,52,48172,46661,94833,103.2383
Portugal,2072,53,47826,47375,95201,100.952
Portugal,2072,54,47616,46965,94581,101.3861
Portugal,2072,55,48233,47170,95403,102.2536
Portugal,2072,56,47140,46687,93827,100.9703
Portugal,2072,57,45752,44686,90438,102.3855
Portugal,2072,58,45347,45145,90492,100.4474
Portugal,2072,59,48781,47918,96699,101.801
Portugal,2072,60,51294,50773,102067,101.0261
Portugal,2072,61,52189,53096,105285,98.2918
Portugal,2072,62,50454,50984,101438,98.9605
Portugal,2072,63,52375,52474,104849,99.8113
Portugal,2072,64,51024,51649,102673,98.7899
Portugal,2072,65,51787,53040,104827,97.6376
Portugal,2072,66,53754,54385,108139,98.8398
Portugal,2072,67,52337,53854,106191,97.1831
Portugal,2072,68,53246,54812,108058,97.143
Portugal,2072,69,53336,54974,108310,97.0204
Portugal,2072,70,52670,54614,107284,96.4405
Portugal,2072,71,55999,58713,114712,95.3775
Portugal,2072,72,53825,57391,111216,93.7865
Portugal,2072,73,51560,55217,106777,93.377
Portugal,2072,74,50061,54682,104743,91.5493
Portugal,2072,75,49056,52876,101932,92.7756
Portugal,2072,76,47359,51831,99190,91.372
Portugal,2072,77,45763,51183,96946,89.4105
Portugal,2072,78,45908,52850,98758,86.8647
Portugal,2072,79,44849,52599,97448,85.2659
Portugal,2072,80,44489,52332,96821,85.013
Portugal,2072,81,42923,51494,94417,83.3553
Portugal,2072,82,41024,49976,91000,82.0874
Portugal,2072,83,39725,49631,89356,80.0407
Portugal,2072,84,37670,48509,86179,77.6557
Portugal,2072,85,35956,47900,83856,75.0647
Portugal,2072,86,34429,47223,81652,72.9073
Portugal,2072,87,33816,48191,82007,70.1708
Portugal,2072,88,31419,46443,77862,67.6507
Portugal,2072,89,29223,45413,74636,64.3494
Portugal,2072,90,25720,42015,67735,61.2162
Portugal,2072,91,23123,39370,62493,58.7325
Portugal,2072,92,19501,34673,54174,56.2426
Portugal,2072,93,16589,31234,47823,53.112
Portugal,2072,94,14591,28694,43285,50.8504
Portugal,2072,95,11607,24376,35983,47.6165
Portugal,2072,96,8789,19449,28238,45.19
Portugal,2072,97,6226,14896,21122,41.7965
Portugal,2072,98,4234,10745,14979,39.4044
Portugal,2072,99,2844,7705,10549,36.9111
Portugal,2072,100,4244,13097,17341,32.4044
Portugal,2073,0,31339,29483,60822,106.2952
Portugal,2073,1,31490,29631,61121,106.2738
Portugal,2073,2,31646,29780,61426,106.266
Portugal,2073,3,31865,29987,61852,106.2627
Portugal,2073,4,32026,30142,62168,106.2504
Portugal,2073,5,32162,30270,62432,106.2504
Portugal,2073,6,32176,30291,62467,106.223
Portugal,2073,7,32286,30393,62679,106.2284
Portugal,2073,8,32465,30565,63030,106.2163
Portugal,2073,9,32562,30656,63218,106.2174
Portugal,2073,10,32639,30730,63369,106.2122
Portugal,2073,11,32914,30990,63904,106.2085
Portugal,2073,12,32946,31022,63968,106.2021
Portugal,2073,13,33022,31101,64123,106.1767
Portugal,2073,14,33307,31377,64684,106.151
Portugal,2073,15,33520,31584,65104,106.1297
Portugal,2073,16,33819,31885,65704,106.0655
Portugal,2073,17,34098,32168,66266,105.9998
Portugal,2073,18,34430,32502,66932,105.9319
Portugal,2073,19,34879,32949,67828,105.8575
Portugal,2073,20,35329,33400,68729,105.7754
Portugal,2073,21,35836,33908,69744,105.686
Portugal,2073,22,36352,34427,70779,105.5915
Portugal,2073,23,37058,35111,72169,105.5453
Portugal,2073,24,37618,35668,73286,105.4671
Portugal,2073,25,38101,36147,74248,105.4057
Portugal,2073,26,38709,36746,75455,105.3421
Portugal,2073,27,39138,37176,76314,105.2776
Portugal,2073,28,39688,37717,77405,105.2258
Portugal,2073,29,40305,38312,78617,105.202
Portugal,2073,30,40992,38980,79972,105.1616
Portugal,2073,31,41473,39449,80922,105.1307
Portugal,2073,32,41904,39874,81778,105.091
Portugal,2073,33,42395,40351,82746,105.0655
Portugal,2073,34,42770,40719,83489,105.037
Portugal,2073,35,42951,40908,83859,104.9941
Portugal,2073,36,43374,41321,84695,104.9684
Portugal,2073,37,43730,41667,85397,104.9512
Portugal,2073,38,43926,41871,85797,104.9079
Portugal,2073,39,44045,41999,86044,104.8715
Portugal,2073,40,43925,41909,85834,104.8104
Portugal,2073,41,44103,42101,86204,104.7552
Portugal,2073,42,44072,42109,86181,104.6617
Portugal,2073,43,44041,42109,86150,104.5881
Portugal,2073,44,44090,42198,86288,104.4836
Portugal,2073,45,44058,42217,86275,104.3608
Portugal,2073,46,44102,42310,86412,104.2354
Portugal,2073,47,44084,42358,86442,104.0748
Portugal,2073,48,44306,42642,86948,103.9023
Portugal,2073,49,44493,42904,87397,103.7036
Portugal,2073,50,44688,43190,87878,103.4684
Portugal,2073,51,44933,43541,88474,103.197
Portugal,2073,52,46927,45458,92385,103.2316
Portugal,2073,53,48075,46641,94716,103.0745
Portugal,2073,54,47719,47350,95069,100.7793
Portugal,2073,55,47499,46937,94436,101.1973
Portugal,2073,56,48101,47137,95238,102.0451
Portugal,2073,57,46998,46649,93647,100.7481
Portugal,2073,58,45601,44647,90248,102.1368
Portugal,2073,59,45182,45099,90281,100.184
Portugal,2073,60,48584,47862,96446,101.5085
Portugal,2073,61,51066,50704,101770,100.7139
Portugal,2073,62,51948,53021,104969,97.9763
Portugal,2073,63,50221,50912,101133,98.6428
Portugal,2073,64,52126,52396,104522,99.4847
Portugal,2073,65,50777,51568,102345,98.4661
Portugal,2073,66,51527,52953,104480,97.307
Portugal,2073,67,53468,54288,107756,98.4895
Portugal,2073,68,52039,53749,105788,96.8185
Portugal,2073,69,52910,54690,107600,96.7453
Portugal,2073,70,52980,54840,107820,96.6083
Portugal,2073,71,52291,54467,106758,96.0049
Portugal,2073,72,55560,58536,114096,94.9159
Portugal,2073,73,53375,57202,110577,93.3097
Portugal,2073,74,51086,55012,106098,92.8634
Portugal,2073,75,49561,54457,104018,91.0094
Portugal,2073,76,48512,52627,101139,92.1808
Portugal,2073,77,46759,51542,98301,90.7202
Portugal,2073,78,45108,50848,95956,88.7115
Portugal,2073,79,45146,52430,97576,86.1072
Portugal,2073,80,43968,52083,96051,84.4191
Portugal,2073,81,43415,51674,95089,84.0171
Portugal,2073,82,41690,50702,92392,82.2256
Portugal,2073,83,39663,49068,88731,80.8327
Portugal,2073,84,38178,48540,86718,78.6527
Portugal,2073,85,35933,47192,83125,76.1421
Portugal,2073,86,33942,46235,80177,73.4119
Portugal,2073,87,32122,45168,77290,71.1167
Portugal,2073,88,31161,45671,76832,68.2293
Portugal,2073,89,28425,43435,71860,65.4426
Portugal,2073,90,25944,41860,67804,61.978
Portugal,2073,91,22406,38091,60497,58.8223
Portugal,2073,92,19788,35146,54934,56.3023
Portugal,2073,93,16455,30605,47060,53.7657
Portugal,2073,94,13660,27030,40690,50.5364
Portugal,2073,95,11623,24140,35763,48.1483
Portugal,2073,96,8917,19842,28759,44.94
Portugal,2073,97,6519,15305,21824,42.5939
Portugal,2073,98,4453,11314,15767,39.3583
Portugal,2073,99,2910,7853,10763,37.0559
Portugal,2073,100,4417,13664,18081,32.3258
Portugal,2074,0,31188,29340,60528,106.2986
Portugal,2074,1,31403,29548,60951,106.2779
Portugal,2074,2,31547,29688,61235,106.2618
Portugal,2074,3,31694,29828,61522,106.2559
Portugal,2074,4,31906,30028,61934,106.2542
Portugal,2074,5,32061,30177,62238,106.2432
Portugal,2074,6,32192,30300,62492,106.2442
Portugal,2074,7,32202,30317,62519,106.2176
Portugal,2074,8,32308,30415,62723,106.2239
Portugal,2074,9,32483,30583,63066,106.2126
Portugal,2074,10,32578,30673,63251,106.2107
Portugal,2074,11,32656,30747,63403,106.2087
Portugal,2074,12,32933,31011,63944,106.1978
Portugal,2074,13,32973,31052,64025,106.1864
Portugal,2074,14,33062,31145,64207,106.1551
Portugal,2074,15,33364,31442,64806,106.1128
Portugal,2074,16,33598,31673,65271,106.0777
Portugal,2074,17,33920,31999,65919,106.0033
Portugal,2074,18,34223,32308,66531,105.9273
Portugal,2074,19,34575,32664,67239,105.8505
Portugal,2074,20,35041,33128,68169,105.7746
Portugal,2074,21,35504,33593,69097,105.6887
Portugal,2074,22,36021,34109,70130,105.6056
Portugal,2074,23,36541,34632,71173,105.5122
Portugal,2074,24,37248,35316,72564,105.4706
Portugal,2074,25,37806,35869,73675,105.4002
Portugal,2074,26,38283,36342,74625,105.3409
Portugal,2074,27,38884,36932,75816,105.2854
Portugal,2074,28,39304,37353,76657,105.2231
Portugal,2074,29,39845,37883,77728,105.1791
Portugal,2074,30,40452,38467,78919,105.1603
Portugal,2074,31,41129,39123,80252,105.1274
Portugal,2074,32,41601,39581,81182,105.1035
Portugal,2074,33,42022,39996,82018,105.0655
Portugal,2074,34,42502,40462,82964,105.0418
Portugal,2074,35,42866,40821,83687,105.0097
Portugal,2074,36,43039,41000,84039,104.9732
Portugal,2074,37,43453,41405,84858,104.9463
Portugal,2074,38,43801,41743,85544,104.9302
Portugal,2074,39,43987,41938,85925,104.8858
Portugal,2074,40,44096,42059,86155,104.8432
Portugal,2074,41,43966,41961,85927,104.7782
Portugal,2074,42,44135,42146,86281,104.7193
Portugal,2074,43,44096,42148,86244,104.6218
Portugal,2074,44,44056,42142,86198,104.5418
Portugal,2074,45,44095,42226,86321,104.4262
Portugal,2074,46,44054,42239,86293,104.297
Portugal,2074,47,44087,42326,86413,104.1606
Portugal,2074,48,44058,42368,86426,103.9889
Portugal,2074,49,44270,42646,86916,103.8081
Portugal,2074,50,44446,42904,87350,103.5941
Portugal,2074,51,44626,43184,87810,103.3392
Portugal,2074,52,44858,43530,88388,103.0508
Portugal,2074,53,46835,45440,92275,103.07
Portugal,2074,54,47970,46617,94587,102.9024
Portugal,2074,55,47604,47323,94927,100.5938
Portugal,2074,56,47372,46905,94277,100.9956
Portugal,2074,57,47958,47100,95058,101.8217
Portugal,2074,58,46845,46609,93454,100.5063
Portugal,2074,59,45438,44604,90042,101.8698
Portugal,2074,60,45004,45048,90052,99.9023
Portugal,2074,61,48372,47799,96171,101.1988
Portugal,2074,62,50833,50635,101468,100.391
Portugal,2074,63,51711,52948,104659,97.6637
Portugal,2074,64,49987,50839,100826,98.3241
Portugal,2074,65,51878,52316,104194,99.1628
Portugal,2074,66,50527,51485,102012,98.1393
Portugal,2074,67,51258,52862,104120,96.9657
Portugal,2074,68,53169,54186,107355,98.1231
Portugal,2074,69,51717,53633,105350,96.4276
Portugal,2074,70,52564,54561,107125,96.3399
Portugal,2074,71,52606,54697,107303,96.1771
Portugal,2074,72,51889,54308,106197,95.5458
Portugal,2074,73,55105,58351,113456,94.4371
Portugal,2074,74,52894,56997,109891,92.8014
Portugal,2074,75,50585,54793,105378,92.3202
Portugal,2074,76,49022,54208,103230,90.4331
Portugal,2074,77,47910,52343,100253,91.5309
Portugal,2074,78,46104,51217,97321,90.017
Portugal,2074,79,44374,50457,94831,87.9442
Portugal,2074,80,44275,51931,96206,85.2574
Portugal,2074,81,42924,51445,94369,83.4367
Portugal,2074,82,42187,50900,93087,82.8821
Portugal,2074,83,40326,49803,90129,80.971
Portugal,2074,84,38141,48015,86156,79.4356
Portugal,2074,85,36441,47252,83693,77.1205
Portugal,2074,86,33944,45585,79529,74.4631
Portugal,2074,87,31692,44259,75951,71.6058
Portugal,2074,88,29625,42846,72471,69.143
Portugal,2074,89,28218,42757,70975,65.9962
Portugal,2074,90,25261,40083,65344,63.0217
Portugal,2074,91,22625,37997,60622,59.5442
Portugal,2074,92,19196,34049,53245,56.3776
Portugal,2074,93,16717,31068,47785,53.8078
Portugal,2074,94,13566,26526,40092,51.1423
Portugal,2074,95,10895,22777,33672,47.8333
Portugal,2074,96,8940,19681,28621,45.4245
Portugal,2074,97,6622,15639,22261,42.3429
Portugal,2074,98,4668,11643,16311,40.0928
Portugal,2074,99,3063,8281,11344,36.9883
Portugal,2074,100,4565,14141,18706,32.282
Portugal,2075,0,31056,29214,60270,106.3052
Portugal,2075,1,31251,29405,60656,106.2778
Portugal,2075,2,31459,29605,61064,106.2625
Portugal,2075,3,31595,29737,61332,106.2481
Portugal,2075,4,31735,29869,61604,106.2473
Portugal,2075,5,31941,30063,62004,106.2469
Portugal,2075,6,32091,30207,62298,106.237
Portugal,2075,7,32217,30325,62542,106.2391
Portugal,2075,8,32224,30338,62562,106.2166
Portugal,2075,9,32327,30433,62760,106.2235
Portugal,2075,10,32500,30600,63100,106.2092
Portugal,2075,11,32594,30690,63284,106.204
Portugal,2075,12,32675,30768,63443,106.198
Portugal,2075,13,32960,31041,64001,106.1821
Portugal,2075,14,33013,31097,64110,106.1614
Portugal,2075,15,33119,31210,64329,106.1166
Portugal,2075,16,33442,31530,64972,106.0641
Portugal,2075,17,33700,31787,65487,106.0182
Portugal,2075,18,34045,32139,66184,105.9305
Portugal,2075,19,34368,32470,66838,105.8454
Portugal,2075,20,34737,32844,67581,105.7636
Portugal,2075,21,35216,33322,68538,105.6839
Portugal,2075,22,35689,33795,69484,105.6044
Portugal,2075,23,36210,34314,70524,105.5254
Portugal,2075,24,36731,34836,71567,105.4398
Portugal,2075,25,37436,35517,72953,105.403
Portugal,2075,26,37989,36064,74053,105.3377
Portugal,2075,27,38459,36529,74988,105.2835
Portugal,2075,28,39051,37109,76160,105.2332
Portugal,2075,29,39462,37518,76980,105.1815
Portugal,2075,30,39992,38037,78029,105.1397
Portugal,2075,31,40590,38610,79200,105.1282
Portugal,2075,32,41257,39256,80513,105.0973
Portugal,2075,33,41719,39703,81422,105.0777
Portugal,2075,34,42129,40108,82237,105.0389
Portugal,2075,35,42599,40564,83163,105.0168
Portugal,2075,36,42955,40914,83869,104.9885
Portugal,2075,37,43119,41085,84204,104.9507
Portugal,2075,38,43524,41481,85005,104.9251
Portugal,2075,39,43862,41810,85672,104.9079
Portugal,2075,40,44038,41998,86036,104.8574
Portugal,2075,41,44137,42111,86248,104.8111
Portugal,2075,42,43999,42006,86005,104.7446
Portugal,2075,43,44160,42185,86345,104.6818
Portugal,2075,44,44111,42182,86293,104.573
Portugal,2075,45,44062,42170,86232,104.4866
Portugal,2075,46,44092,42248,86340,104.3647
Portugal,2075,47,44039,42255,86294,104.222
Portugal,2075,48,44062,42336,86398,104.0769
Portugal,2075,49,44023,42374,86397,103.8915
Portugal,2075,50,44224,42647,86871,103.6978
Portugal,2075,51,44386,42899,87285,103.4663
Portugal,2075,52,44553,43174,87727,103.1941
Portugal,2075,53,44772,43514,88286,102.891
Portugal,2075,54,46734,45419,92153,102.8953
Portugal,2075,55,47855,46592,94447,102.7108
Portugal,2075,56,47478,47292,94770,100.3933
Portugal,2075,57,47234,46869,94103,100.7788
Portugal,2075,58,47804,47060,94864,101.581
Portugal,2075,59,46679,46564,93243,100.247
Portugal,2075,60,45261,44555,89816,101.5846
Portugal,2075,61,44811,44992,89803,99.5977
Portugal,2075,62,48156,47736,95892,100.8798
Portugal,2075,63,50606,50568,101174,100.0751
Portugal,2075,64,51474,52875,104349,97.3504
Portugal,2075,65,49754,50765,100519,98.0085
Portugal,2075,66,51628,52235,103863,98.8379
Portugal,2075,67,50269,51400,101669,97.7996
Portugal,2075,68,50977,52766,103743,96.6096
Portugal,2075,69,52846,54073,106919,97.7308
Portugal,2075,70,51385,53511,104896,96.027
Portugal,2075,71,52200,54423,106623,95.9153
Portugal,2075,72,52210,54543,106753,95.7226
Portugal,2075,73,51473,54142,105615,95.0704
Portugal,2075,74,54617,58148,112765,93.9276
Portugal,2075,75,52387,56778,109165,92.2664
Portugal,2075,76,50046,54552,104598,91.74
Portugal,2075,77,48425,53926,102351,89.799
Portugal,2075,78,47251,52023,99274,90.8271
Portugal,2075,79,45367,50835,96202,89.2436
Portugal,2075,80,43533,49991,93524,87.0817
Portugal,2075,81,43240,51312,94552,84.2688
Portugal,2075,82,41728,50694,92422,82.3135
Portugal,2075,83,40828,50020,90848,81.6234
Portugal,2075,84,38801,48760,87561,79.5755
Portugal,2075,85,36429,46769,83198,77.8913
Portugal,2075,86,34449,45676,80125,75.4204
Portugal,2075,87,31720,43672,75392,72.6324
Portugal,2075,88,29255,42024,71279,69.615
Portugal,2075,89,26854,40154,67008,66.8775
Portugal,2075,90,25103,39503,64606,63.5471
Portugal,2075,91,22053,36428,58481,60.5386
Portugal,2075,92,19405,34010,53415,57.0567
Portugal,2075,93,16237,30142,46379,53.8684
Portugal,2075,94,13800,26969,40769,51.1699
Portugal,2075,95,10834,22388,33222,48.392
Portugal,2075,96,8391,18599,26990,45.1153
Portugal,2075,97,6648,15538,22186,42.7854
Portugal,2075,98,4747,11916,16663,39.8372
Portugal,2075,99,3215,8534,11749,37.6728
Portugal,2075,100,4761,14757,19518,32.2627
Portugal,2076,0,30987,29153,60140,106.2909
Portugal,2076,1,31119,29280,60399,106.2807
Portugal,2076,2,31307,29462,60769,106.2623
Portugal,2076,3,31507,29654,61161,106.2487
Portugal,2076,4,31636,29778,61414,106.2395
Portugal,2076,5,31770,29904,61674,106.24
Portugal,2076,6,31970,30093,62063,106.2373
Portugal,2076,7,32116,30233,62349,106.2283
Portugal,2076,8,32239,30347,62586,106.2346
Portugal,2076,9,32242,30357,62599,106.2094
Portugal,2076,10,32343,30450,62793,106.2167
Portugal,2076,11,32516,30617,63133,106.2024
Portugal,2076,12,32614,30711,63325,106.1965
Portugal,2076,13,32702,30798,63500,106.1822
Portugal,2076,14,33000,31085,64085,106.1605
Portugal,2076,15,33070,31161,64231,106.1262
Portugal,2076,16,33197,31299,64496,106.0641
Portugal,2076,17,33544,31645,65189,106.0009
Portugal,2076,18,33825,31927,65752,105.9448
Portugal,2076,19,34190,32301,66491,105.8481
Portugal,2076,20,34530,32650,67180,105.758
Portugal,2076,21,34913,33037,67950,105.6785
Portugal,2076,22,35401,33524,68925,105.599
Portugal,2076,23,35879,34000,69879,105.5265
Portugal,2076,24,36400,34519,70919,105.4492
Portugal,2076,25,36919,35038,71957,105.3685
Portugal,2076,26,37619,35712,73331,105.3399
Portugal,2076,27,38164,36251,74415,105.2771
Portugal,2076,28,38626,36705,75331,105.2336
Portugal,2076,29,39208,37275,76483,105.1858
Portugal,2076,30,39609,37673,77282,105.139
Portugal,2076,31,40130,38181,78311,105.1046
Portugal,2076,32,40718,38743,79461,105.0977
Portugal,2076,33,41376,39378,80754,105.0739
Portugal,2076,34,41827,39815,81642,105.0534
Portugal,2076,35,42226,40210,82436,105.0137
Portugal,2076,36,42688,40657,83345,104.9954
Portugal,2076,37,43035,40998,84033,104.9685
Portugal,2076,38,43191,41160,84351,104.9344
Portugal,2076,39,43586,41548,85134,104.9052
Portugal,2076,40,43914,41870,85784,104.8818
Portugal,2076,41,44080,42050,86130,104.8276
Portugal,2076,42,44171,42157,86328,104.7774
Portugal,2076,43,44024,42046,86070,104.7044
Portugal,2076,44,44175,42219,86394,104.633
Portugal,2076,45,44118,42211,86329,104.5178
Portugal,2076,46,44059,42193,86252,104.4225
Portugal,2076,47,44078,42265,86343,104.2896
Portugal,2076,48,44015,42266,86281,104.1381
Portugal,2076,49,44028,42342,86370,103.9819
Portugal,2076,50,43979,42375,86354,103.7853
Portugal,2076,51,44166,42643,86809,103.5715
Portugal,2076,52,44315,42890,87205,103.3225
Portugal,2076,53,44470,43159,87629,103.0376
Portugal,2076,54,44679,43496,88175,102.7198
Portugal,2076,55,46625,45396,92021,102.7073
Portugal,2076,56,47731,46562,94293,102.5106
Portugal,2076,57,47342,47257,94599,100.1799
Portugal,2076,58,47085,46831,93916,100.5424
Portugal,2076,59,47637,47016,94653,101.3208
Portugal,2076,60,46500,46514,93014,99.9699
Portugal,2076,61,45070,44500,89570,101.2809
Portugal,2076,62,44615,44935,89550,99.2879
Portugal,2076,63,47945,47676,95621,100.5642
Portugal,2076,64,50378,50500,100878,99.7584
Portugal,2076,65,51238,52799,104037,97.0435
Portugal,2076,66,49518,50689,100207,97.6898
Portugal,2076,67,51368,52151,103519,98.4986
Portugal,2076,68,49999,51310,101309,97.4449
Portugal,2076,69,50674,52659,103333,96.2305
Portugal,2076,70,52513,53954,106467,97.3292
Portugal,2076,71,51037,53380,104417,95.6107
Portugal,2076,72,51814,54275,106089,95.4657
Portugal,2076,73,51799,54382,106181,95.2503
Portugal,2076,74,51027,53961,104988,94.5627
Portugal,2076,75,54104,57932,112036,93.3923
Portugal,2076,76,51840,56536,108376,91.6938
Portugal,2076,77,49449,54276,103725,91.1066
Portugal,2076,78,47773,53606,101379,89.1188
Portugal,2076,79,46510,51647,98157,90.0536
Portugal,2076,80,44522,50379,94901,88.3741
Portugal,2076,81,42532,49412,91944,86.0763
Portugal,2076,82,42055,50582,92637,83.1422
Portugal,2076,83,40404,49839,90243,81.069
Portugal,2076,84,39306,48997,88303,80.2212
Portugal,2076,85,37083,47523,84606,78.0317
Portugal,2076,86,34462,45240,79702,76.176
Portugal,2076,87,32216,43795,76011,73.5609
Portugal,2076,88,29305,41505,70810,70.606
Portugal,2076,89,26542,39424,65966,67.3245
Portugal,2076,90,23913,37140,61053,64.3861
Portugal,2076,91,21938,35945,57883,61.0321
Portugal,2076,92,18935,32649,51584,57.9957
Portugal,2076,93,16433,30150,46583,54.5041
Portugal,2076,94,13420,26204,39624,51.2136
Portugal,2076,95,11035,22796,33831,48.4076
Portugal,2076,96,8354,18310,26664,45.6253
Portugal,2076,97,6247,14706,20953,42.4793
Portugal,2076,98,4771,11857,16628,40.2378
Portugal,2076,99,3273,8748,12021,37.4143
Portugal,2076,100,4981,15346,20327,32.458
Portugal,2077,0,30579,28765,59344,106.3063
Portugal,2077,1,31051,29218,60269,106.2735
Portugal,2077,2,31176,29337,60513,106.2685
Portugal,2077,3,31356,29511,60867,106.2519
Portugal,2077,4,31548,29695,61243,106.2401
Portugal,2077,5,31671,29813,61484,106.2322
Portugal,2077,6,31800,29934,61734,106.2337
Portugal,2077,7,31996,30118,62114,106.2355
Portugal,2077,8,32138,30254,62392,106.2273
Portugal,2077,9,32258,30366,62624,106.2307
Portugal,2077,10,32259,30374,62633,106.206
Portugal,2077,11,32360,30467,62827,106.2133
Portugal,2077,12,32536,30638,63174,106.1949
Portugal,2077,13,32641,30741,63382,106.1807
Portugal,2077,14,32742,30843,63585,106.157
Portugal,2077,15,33057,31150,64207,106.122
Portugal,2077,16,33149,31250,64399,106.0768
Portugal,2077,17,33299,31413,64712,106.0039
Portugal,2077,18,33669,31784,65453,105.9307
Portugal,2077,19,33970,32089,66059,105.8618
Portugal,2077,20,34352,32481,66833,105.7603
Portugal,2077,21,34706,32843,67549,105.6724
Portugal,2077,22,35098,33239,68337,105.5928
Portugal,2077,23,35591,33729,69320,105.5205
Portugal,2077,24,36069,34205,70274,105.4495
Portugal,2077,25,36589,34721,71310,105.38
Portugal,2077,26,37102,35233,72335,105.3047
Portugal,2077,27,37794,35899,73693,105.2787
Portugal,2077,28,38331,36428,74759,105.224
Portugal,2077,29,38783,36871,75654,105.1856
Portugal,2077,30,39356,37429,76785,105.1484
Portugal,2077,31,39747,37817,77564,105.1035
Portugal,2077,32,40259,38314,78573,105.0765
Portugal,2077,33,40837,38865,79702,105.074
Portugal,2077,34,41483,39490,80973,105.0468
Portugal,2077,35,41924,39917,81841,105.0279
Portugal,2077,36,42315,40303,82618,104.9922
Portugal,2077,37,42768,40741,83509,104.9753
Portugal,2077,38,43106,41074,84180,104.9472
Portugal,2077,39,43253,41228,84481,104.9117
Portugal,2077,40,43638,41608,85246,104.8789
Portugal,2077,41,43956,41923,85879,104.8494
Portugal,2077,42,44114,42096,86210,104.7938
Portugal,2077,43,44196,42197,86393,104.7373
Portugal,2077,44,44040,42080,86120,104.6578
Portugal,2077,45,44183,42248,86431,104.5801
Portugal,2077,46,44115,42234,86349,104.4538
Portugal,2077,47,44046,42210,86256,104.3497
Portugal,2077,48,44055,42277,86332,104.2056
Portugal,2077,49,43983,42273,86256,104.0451
Portugal,2077,50,43985,42344,86329,103.8754
Portugal,2077,51,43923,42372,86295,103.6604
Portugal,2077,52,44096,42635,86731,103.4268
Portugal,2077,53,44234,42877,87111,103.1649
Portugal,2077,54,44379,43142,87521,102.8673
Portugal,2077,55,44578,43475,88053,102.5371
Portugal,2077,56,46507,45368,91875,102.5106
Portugal,2077,57,47596,46529,94125,102.2932
Portugal,2077,58,47195,47220,94415,99.9471
Portugal,2077,59,46923,46789,93712,100.2864
Portugal,2077,60,47458,46967,94425,101.0454
Portugal,2077,61,46307,46458,92765,99.675
Portugal,2077,62,44877,44446,89323,100.9697
Portugal,2077,63,44424,44880,89304,98.984
Portugal,2077,64,47734,47614,95348,100.252
Portugal,2077,65,50152,50431,100583,99.4468
Portugal,2077,66,51001,52722,103723,96.7357
Portugal,2077,67,49276,50610,99886,97.3642
Portugal,2077,68,51099,52063,103162,98.1484
Portugal,2077,69,49708,51209,100917,97.0689
Portugal,2077,70,50363,52547,102910,95.8437
Portugal,2077,71,52166,53826,105992,96.916
Portugal,2077,72,50669,53240,103909,95.1709
Portugal,2077,73,51417,54120,105537,95.0055
Portugal,2077,74,51361,54206,105567,94.7515
Portugal,2077,75,50560,53767,104327,94.0354
Portugal,2077,76,53553,57693,111246,92.8241
Portugal,2077,77,51236,56260,107496,91.07
Portugal,2077,78,48799,53966,102765,90.4255
Portugal,2077,79,47041,53232,100273,88.3698
Portugal,2077,80,45663,51198,96861,89.189
Portugal,2077,81,43519,49811,93330,87.3683
Portugal,2077,82,41388,48727,90115,84.9385
Portugal,2077,83,40745,49751,90496,81.8979
Portugal,2077,84,38924,48844,87768,79.6904
Portugal,2077,85,37594,47782,85376,78.6782
Portugal,2077,86,35110,46002,81112,76.3228
Portugal,2077,87,32258,43412,75670,74.3066
Portugal,2077,88,29795,41659,71454,71.5212
Portugal,2077,89,26618,38976,65594,68.2933
Portugal,2077,90,23665,36505,60170,64.8267
Portugal,2077,91,20925,33836,54761,61.8424
Portugal,2077,92,18861,32257,51118,58.471
Portugal,2077,93,16058,28985,45043,55.4011
Portugal,2077,94,13602,26251,39853,51.8152
Portugal,2077,95,10747,22185,32932,48.4426
Portugal,2077,96,8522,18674,27196,45.6356
Portugal,2077,97,6229,14501,20730,42.9557
Portugal,2077,98,4490,11241,15731,39.9431
Portugal,2077,99,3294,8718,12012,37.7839
Portugal,2077,100,5158,15884,21042,32.4729
Portugal,2078,0,30333,28532,58865,106.3122
Portugal,2078,1,30643,28831,59474,106.2849
Portugal,2078,2,31107,29275,60382,106.2579
Portugal,2078,3,31224,29385,60609,106.2583
Portugal,2078,4,31397,29552,60949,106.2432
Portugal,2078,5,31583,29730,61313,106.2328
Portugal,2078,6,31701,29843,61544,106.2259
Portugal,2078,7,31825,29960,61785,106.225
Portugal,2078,8,32018,30140,62158,106.2309
Portugal,2078,9,32157,30273,62430,106.2234
Portugal,2078,10,32274,30383,62657,106.2239
Portugal,2078,11,32275,30391,62666,106.1992
Portugal,2078,12,32379,30488,62867,106.2024
Portugal,2078,13,32563,30668,63231,106.1791
Portugal,2078,14,32681,30786,63467,106.1554
Portugal,2078,15,32799,30907,63706,106.1216
Portugal,2078,16,33135,31239,64374,106.0693
Portugal,2078,17,33250,31364,64614,106.0133
Portugal,2078,18,33424,31553,64977,105.9297
Portugal,2078,19,33814,31946,65760,105.8474
Portugal,2078,20,34132,32269,66401,105.7733
Portugal,2078,21,34528,32674,67202,105.6742
Portugal,2078,22,34891,33045,67936,105.5863
Portugal,2078,23,35288,33444,68732,105.5137
Portugal,2078,24,35781,33934,69715,105.4429
Portugal,2078,25,36258,34407,70665,105.3797
Portugal,2078,26,36772,34916,71688,105.3156
Portugal,2078,27,37278,35420,72698,105.2456
Portugal,2078,28,37962,36076,74038,105.2279
Portugal,2078,29,38489,36594,75083,105.1784
Portugal,2078,30,38932,37026,75958,105.1477
Portugal,2078,31,39494,37573,77067,105.1127
Portugal,2078,32,39876,37950,77826,105.0751
Portugal,2078,33,40378,38436,78814,105.0526
Portugal,2078,34,40945,38977,79922,105.0491
Portugal,2078,35,41581,39592,81173,105.0237
Portugal,2078,36,42013,40011,82024,105.0036
Portugal,2078,37,42396,40388,82784,104.9718
Portugal,2078,38,42840,40817,83657,104.9563
Portugal,2078,39,43169,41142,84311,104.9268
Portugal,2078,40,43305,41289,84594,104.8827
Portugal,2078,41,43681,41662,85343,104.8461
Portugal,2078,42,43991,41969,85960,104.8178
Portugal,2078,43,44139,42136,86275,104.7537
Portugal,2078,44,44213,42232,86445,104.6908
Portugal,2078,45,44049,42110,86159,104.6046
Portugal,2078,46,44181,42272,86453,104.516
Portugal,2078,47,44103,42251,86354,104.3833
Portugal,2078,48,44025,42222,86247,104.2703
Portugal,2078,49,44023,42284,86307,104.1127
Portugal,2078,50,43941,42276,86217,103.9384
Portugal,2078,51,43930,42342,86272,103.7504
Portugal,2078,52,43855,42364,86219,103.5195
Portugal,2078,53,44018,42622,86640,103.2753
Portugal,2078,54,44145,42860,87005,102.9981
Portugal,2078,55,44280,43122,87402,102.6854
Portugal,2078,56,44468,43451,87919,102.3406
Portugal,2078,57,46378,45338,91716,102.2939
Portugal,2078,58,47451,46494,93945,102.0583
Portugal,2078,59,47036,47178,94214,99.699
Portugal,2078,60,46749,46741,93490,100.0171
Portugal,2078,61,47264,46912,94176,100.7503
Portugal,2078,62,46111,46403,92514,99.3707
Portugal,2078,63,44688,44393,89081,100.6645
Portugal,2078,64,44233,44824,89057,98.6815
Portugal,2078,65,47525,47551,95076,99.9453
Portugal,2078,66,49925,50360,100285,99.1362
Portugal,2078,67,50755,52643,103398,96.4136
Portugal,2078,68,49022,50527,99549,97.0214
Portugal,2078,69,50807,51964,102771,97.7735
Portugal,2078,70,49409,51104,100513,96.6832
Portugal,2078,71,50036,52427,102463,95.4394
Portugal,2078,72,51797,53689,105486,96.476
Portugal,2078,73,50289,53093,103382,94.7187
Portugal,2078,74,50992,53951,104943,94.5154
Portugal,2078,75,50901,54018,104919,94.2297
Portugal,2078,76,50056,53553,103609,93.47
Portugal,2078,77,52942,57421,110363,92.1997
Portugal,2078,78,50575,55948,106523,90.3964
Portugal,2078,79,48065,53600,101665,89.6735
Portugal,2078,80,46199,52782,98981,87.5279
Portugal,2078,81,44651,50636,95287,88.1803
Portugal,2078,82,42366,49138,91504,86.2184
Portugal,2078,83,40118,47946,88064,83.6733
Portugal,2078,84,39273,48782,88055,80.5072
Portugal,2078,85,37252,47660,84912,78.162
Portugal,2078,86,35619,46283,81902,76.9591
Portugal,2078,87,32890,44177,77067,74.4505
Portugal,2078,88,29859,41332,71191,72.2418
Portugal,2078,89,27088,39159,66247,69.1744
Portugal,2078,90,23756,36131,59887,65.7496
Portugal,2078,91,20729,33297,54026,62.2549
Portugal,2078,92,18009,30403,48412,59.2343
Portugal,2078,93,16014,28677,44691,55.8427
Portugal,2078,94,13309,25274,38583,52.6589
Portugal,2078,95,10907,22259,33166,49.0004
Portugal,2078,96,8310,18202,26512,45.6543
Portugal,2078,97,6362,14813,21175,42.9488
Portugal,2078,98,4482,11101,15583,40.3747
Portugal,2078,99,3103,8277,11380,37.4894
Portugal,2078,100,5283,16221,21504,32.5689
Portugal,2079,0,30197,28410,58607,106.29
Portugal,2079,1,30397,28598,58995,106.2906
Portugal,2079,2,30699,28888,59587,106.269
Portugal,2079,3,31156,29324,60480,106.2474
Portugal,2079,4,31265,29427,60692,106.246
Portugal,2079,5,31432,29587,61019,106.2358
Portugal,2079,6,31613,29760,61373,106.2265
Portugal,2079,7,31726,29869,61595,106.2171
Portugal,2079,8,31847,29981,61828,106.2239
Portugal,2079,9,32036,30159,62195,106.2237
Portugal,2079,10,32173,30290,62463,106.2166
Portugal,2079,11,32291,30400,62691,106.2204
Portugal,2079,12,32295,30412,62707,106.1916
Portugal,2079,13,32406,30518,62924,106.1865
Portugal,2079,14,32602,30713,63315,106.1505
Portugal,2079,15,32738,30850,63588,106.1199
Portugal,2079,16,32878,30996,63874,106.0718
Portugal,2079,17,33237,31353,64590,106.009
Portugal,2079,18,33375,31504,64879,105.9389
Portugal,2079,19,33569,31715,65284,105.8458
Portugal,2079,20,33976,32126,66102,105.7586
Portugal,2079,21,34308,32463,66771,105.6834
Portugal,2079,22,34714,32876,67590,105.5907
Portugal,2079,23,35081,33251,68332,105.5036
Portugal,2079,24,35479,33649,69128,105.4385
Portugal,2079,25,35970,34135,70105,105.3757
Portugal,2079,26,36441,34602,71043,105.3147
Portugal,2079,27,36948,35103,72051,105.256
Portugal,2079,28,37446,35596,73042,105.1972
Portugal,2079,29,38120,36242,74362,105.1818
Portugal,2079,30,38638,36749,75387,105.1403
Portugal,2079,31,39070,37170,76240,105.1116
Portugal,2079,32,39623,37706,77329,105.0841
Portugal,2079,33,39995,38072,78067,105.051
Portugal,2079,34,40486,38548,79034,105.0275
Portugal,2079,35,41043,39080,80123,105.023
Portugal,2079,36,41671,39686,81357,105.0018
Portugal,2079,37,42095,40095,82190,104.9882
Portugal,2079,38,42468,40464,82932,104.9526
Portugal,2079,39,42903,40886,83789,104.9332
Portugal,2079,40,43222,41203,84425,104.9001
Portugal,2079,41,43349,41342,84691,104.8546
Portugal,2079,42,43716,41708,85424,104.8144
Portugal,2079,43,44017,42010,86027,104.7774
Portugal,2079,44,44157,42172,86329,104.7069
Portugal,2079,45,44221,42261,86482,104.6378
Portugal,2079,46,44048,42133,86181,104.5451
Portugal,2079,47,44170,42290,86460,104.4455
Portugal,2079,48,44082,42264,86346,104.3015
Portugal,2079,49,43994,42230,86224,104.1771
Portugal,2079,50,43982,42287,86269,104.0083
Portugal,2079,51,43887,42274,86161,103.8156
Portugal,2079,52,43864,42335,86199,103.6117
Portugal,2079,53,43779,42353,86132,103.3669
Portugal,2079,54,43932,42607,86539,103.1098
Portugal,2079,55,44050,42842,86892,102.8197
Portugal,2079,56,44173,43099,87272,102.4919
Portugal,2079,57,44348,43423,87771,102.1302
Portugal,2079,58,46240,45305,91545,102.0638
Portugal,2079,59,47294,46455,93749,101.806
Portugal,2079,60,46865,47132,93997,99.4335
Portugal,2079,61,46562,46688,93250,99.7301
Portugal,2079,62,47067,46858,93925,100.446
Portugal,2079,63,45921,46349,92270,99.0766
Portugal,2079,64,44500,44340,88840,100.3608
Portugal,2079,65,44044,44767,88811,98.385
Portugal,2079,66,47314,47487,94801,99.6357
Portugal,2079,67,49690,50287,99977,98.8128
Portugal,2079,68,50500,52560,103060,96.0807
Portugal,2079,69,48750,50435,99185,96.6591
Portugal,2079,70,50509,51861,102370,97.393
Portugal,2079,71,49096,50992,100088,96.2818
Portugal,2079,72,49691,52298,101989,95.0151
Portugal,2079,73,51417,53546,104963,96.024
Portugal,2079,74,49883,52933,102816,94.238
Portugal,2079,75,50545,53770,104315,94.0022
Portugal,2079,76,50405,53811,104216,93.6704
Portugal,2079,77,49498,53309,102807,92.8511
Portugal,2079,78,52275,57113,109388,91.5291
Portugal,2079,79,49832,55581,105413,89.6565
Portugal,2079,80,47224,53161,100385,88.832
Portugal,2079,81,45196,52218,97414,86.5525
Portugal,2079,82,43491,49970,93461,87.0342
Portugal,2079,83,41090,48371,89461,84.9476
Portugal,2079,84,38695,47034,85729,82.2703
Portugal,2079,85,37614,47626,85240,78.9779
Portugal,2079,86,35324,46197,81521,76.4638
Portugal,2079,87,33397,44482,77879,75.0798
Portugal,2079,88,30475,42098,72573,72.3906
Portugal,2079,89,27176,38890,66066,69.8791
Portugal,2079,90,24205,36341,60546,66.6052
Portugal,2079,91,20835,32994,53829,63.1478
Portugal,2079,92,17864,29958,47822,59.6301
Portugal,2079,93,15313,27067,42380,56.5744
Portugal,2079,94,13292,25043,38335,53.0767
Portugal,2079,95,10688,21463,32151,49.7973
Portugal,2079,96,8446,18292,26738,46.1732
Portugal,2079,97,6213,14461,20674,42.9638
Portugal,2079,98,4584,11358,15942,40.3592
Portugal,2079,99,3102,8187,11289,37.8893
Portugal,2079,100,5233,16126,21359,32.4507
Portugal,2080,0,29965,28193,58158,106.2852
Portugal,2080,1,30261,28476,58737,106.2684
Portugal,2080,2,30454,28655,59109,106.2781
Portugal,2080,3,30748,28936,59684,106.2621
Portugal,2080,4,31197,29365,60562,106.2387
Portugal,2080,5,31300,29462,60762,106.2385
Portugal,2080,6,31462,29617,61079,106.2295
Portugal,2080,7,31639,29785,61424,106.2246
Portugal,2080,8,31748,29890,61638,106.2161
Portugal,2080,9,31866,30000,61866,106.22
Portugal,2080,10,32053,30175,62228,106.2237
Portugal,2080,11,32189,30307,62496,106.2098
Portugal,2080,12,32310,30421,62731,106.2095
Portugal,2080,13,32322,30442,62764,106.1757
Portugal,2080,14,32446,30563,63009,106.161
Portugal,2080,15,32660,30778,63438,106.1148
Portugal,2080,16,32816,30939,63755,106.0668
Portugal,2080,17,32979,31110,64089,106.0077
Portugal,2080,18,33362,31493,64855,105.9347
Portugal,2080,19,33520,31666,65186,105.8549
Portugal,2080,20,33732,31895,65627,105.7595
Portugal,2080,21,34153,32320,66473,105.6714
Portugal,2080,22,34494,32665,67159,105.5993
Portugal,2080,23,34904,33082,67986,105.5075
Portugal,2080,24,35272,33456,68728,105.428
Portugal,2080,25,35667,33851,69518,105.3647
Portugal,2080,26,36153,34331,70484,105.3072
Portugal,2080,27,36617,34789,71406,105.2545
Portugal,2080,28,37116,35279,72395,105.2071
Portugal,2080,29,37604,35762,73366,105.1507
Portugal,2080,30,38268,36397,74665,105.1405
Portugal,2080,31,38776,36893,75669,105.1039
Portugal,2080,32,39199,37303,76502,105.0827
Portugal,2080,33,39743,37829,77572,105.0596
Portugal,2080,34,40104,38185,78289,105.0255
Portugal,2080,35,40584,38651,79235,105.0012
Portugal,2080,36,41133,39173,80306,105.0034
Portugal,2080,37,41752,39771,81523,104.981
Portugal,2080,38,42167,40172,82339,104.9661
Portugal,2080,39,42531,40532,83063,104.9319
Portugal,2080,40,42956,40947,83903,104.9063
Portugal,2080,41,43266,41257,84523,104.8695
Portugal,2080,42,43385,41389,84774,104.8225
Portugal,2080,43,43743,41749,85492,104.7762
Portugal,2080,44,44035,42045,86080,104.733
Portugal,2080,45,44166,42202,86368,104.6538
Portugal,2080,46,44221,42285,86506,104.5785
Portugal,2080,47,44037,42152,86189,104.4719
Portugal,2080,48,44150,42303,86453,104.3661
Portugal,2080,49,44053,42272,86325,104.2132
Portugal,2080,50,43954,42234,86188,104.0725
Portugal,2080,51,43930,42286,86216,103.8878
Portugal,2080,52,43823,42268,86091,103.6789
Portugal,2080,53,43789,42325,86114,103.4589
Portugal,2080,54,43695,42339,86034,103.2027
Portugal,2080,55,43838,42590,86428,102.9303
Portugal,2080,56,43945,42820,86765,102.6273
Portugal,2080,57,44056,43073,87129,102.2822
Portugal,2080,58,44218,43393,87611,101.9012
Portugal,2080,59,46090,45268,91358,101.8159
Portugal,2080,60,47125,46410,93535,101.5406
Portugal,2080,61,46680,47080,93760,99.1504
Portugal,2080,62,46372,46636,93008,99.4339
Portugal,2080,63,46876,46806,93682,100.1496
Portugal,2080,64,45731,46295,92026,98.7817
Portugal,2080,65,44313,44286,88599,100.061
Portugal,2080,66,43853,44710,88563,98.0832
Portugal,2080,67,47097,47421,94518,99.3168
Portugal,2080,68,49446,50210,99656,98.4784
Portugal,2080,69,50224,52467,102691,95.7249
Portugal,2080,70,48469,50338,98807,96.2871
Portugal,2080,71,50195,51751,101946,96.9933
Portugal,2080,72,48765,50871,99636,95.8601
Portugal,2080,73,49335,52164,101499,94.5767
Portugal,2080,74,51011,53391,104402,95.5423
Portugal,2080,75,49456,52762,102218,93.7341
Portugal,2080,76,50064,53572,103636,93.4518
Portugal,2080,77,49856,53574,103430,93.0601
Portugal,2080,78,48888,53034,101922,92.1824
Portugal,2080,79,51522,56752,108274,90.7845
Portugal,2080,80,48976,55141,104117,88.8196
Portugal,2080,81,46215,52611,98826,87.8428
Portugal,2080,82,44039,51551,95590,85.428
Portugal,2080,83,42201,49211,91412,85.7552
Portugal,2080,84,39654,47476,87130,83.5243
Portugal,2080,85,37082,45949,83031,80.7025
Portugal,2080,86,35691,46197,81888,77.2583
Portugal,2080,87,33145,44437,77582,74.5887
Portugal,2080,88,30970,42430,73400,72.9908
Portugal,2080,89,27762,39654,67416,70.0106
Portugal,2080,90,24308,36135,60443,67.27
Portugal,2080,91,21250,33230,54480,63.9482
Portugal,2080,92,17975,29728,47703,60.4649
Portugal,2080,93,15208,26712,41920,56.9332
Portugal,2080,94,12726,23676,36402,53.7506
Portugal,2080,95,10688,21304,31992,50.169
Portugal,2080,96,8287,17669,25956,46.9014
Portugal,2080,97,6322,14558,20880,43.4263
Portugal,2080,98,4482,11107,15589,40.3529
Portugal,2080,99,3176,8390,11566,37.8546
Portugal,2080,100,5200,16002,21202,32.4959
Portugal,2081,0,29914,28147,58061,106.2778
Portugal,2081,1,30029,28259,58288,106.2635
Portugal,2081,2,30317,28533,58850,106.2524
Portugal,2081,3,30502,28704,59206,106.2639
Portugal,2081,4,30789,28978,59767,106.2496
Portugal,2081,5,31232,29400,60632,106.2313
Portugal,2081,6,31330,29492,60822,106.2322
Portugal,2081,7,31487,29642,61129,106.2243
Portugal,2081,8,31660,29807,61467,106.2167
Portugal,2081,9,31767,29909,61676,106.2122
Portugal,2081,10,31882,30017,61899,106.2131
Portugal,2081,11,32069,30193,62262,106.2134
Portugal,2081,12,32209,30328,62537,106.2022
Portugal,2081,13,32337,30451,62788,106.1936
Portugal,2081,14,32362,30487,62849,106.1502
Portugal,2081,15,32503,30628,63131,106.1218
Portugal,2081,16,32738,30866,63604,106.0649
Portugal,2081,17,32918,31054,63972,106.0024
Portugal,2081,18,33104,31250,64354,105.9328
Portugal,2081,19,33507,31655,65162,105.8506
Portugal,2081,20,33683,31846,65529,105.7684
Portugal,2081,21,33908,32088,65996,105.6719
Portugal,2081,22,34338,32522,66860,105.5839
Portugal,2081,23,34684,32870,67554,105.5187
Portugal,2081,24,35094,33287,68381,105.4285
Portugal,2081,25,35460,33657,69117,105.357
Portugal,2081,26,35851,34046,69897,105.3017
Portugal,2081,27,36330,34517,70847,105.2525
Portugal,2081,28,36785,34965,71750,105.2052
Portugal,2081,29,37274,35446,72720,105.1571
Portugal,2081,30,37753,35918,73671,105.1089
Portugal,2081,31,38407,36541,74948,105.1066
Portugal,2081,32,38906,37026,75932,105.0775
Portugal,2081,33,39319,37426,76745,105.058
Portugal,2081,34,39851,37941,77792,105.0341
Portugal,2081,35,40203,38287,78490,105.0043
Portugal,2081,36,40675,38745,79420,104.9813
Portugal,2081,37,41214,39259,80473,104.9797
Portugal,2081,38,41825,39848,81673,104.9614
Portugal,2081,39,42231,40241,82472,104.9452
Portugal,2081,40,42585,40594,83179,104.9047
Portugal,2081,41,43001,41001,84002,104.8779
Portugal,2081,42,43302,41304,84606,104.8373
Portugal,2081,43,43412,41430,84842,104.784
Portugal,2081,44,43762,41785,85547,104.7314
Portugal,2081,45,44045,42076,86121,104.6796
Portugal,2081,46,44167,42226,86393,104.5967
Portugal,2081,47,44211,42304,86515,104.5078
Portugal,2081,48,44018,42166,86184,104.3922
Portugal,2081,49,44121,42312,86433,104.2754
Portugal,2081,50,44014,42276,86290,104.1111
Portugal,2081,51,43904,42234,86138,103.9542
Portugal,2081,52,43868,42281,86149,103.7535
Portugal,2081,53,43750,42258,86008,103.5307
Portugal,2081,54,43707,42312,86019,103.2969
Portugal,2081,55,43604,42323,85927,103.0267
Portugal,2081,56,43736,42569,86305,102.7414
Portugal,2081,57,43831,42795,86626,102.4208
Portugal,2081,58,43931,43045,86976,102.0583
Portugal,2081,59,44078,43360,87438,101.6559
Portugal,2081,60,45928,45227,91155,101.55
Portugal,2081,61,46942,46361,93303,101.2532
Portugal,2081,62,46493,47028,93521,98.8624
Portugal,2081,63,46188,46586,92774,99.1457
Portugal,2081,64,46686,46753,93439,99.8567
Portugal,2081,65,45543,46240,91783,98.4926
Portugal,2081,66,44126,44231,88357,99.7626
Portugal,2081,67,43657,44650,88307,97.776
Portugal,2081,68,46871,47352,94223,98.9842
Portugal,2081,69,49182,50125,99307,98.1187
Portugal,2081,70,49942,52369,102311,95.3656
Portugal,2081,71,48176,50235,98411,95.9013
Portugal,2081,72,49864,51633,101497,96.5739
Portugal,2081,73,48424,50746,99170,95.4243
Portugal,2081,74,48955,52018,100973,94.1117
Portugal,2081,75,50585,53225,103810,95.0399
Portugal,2081,76,48996,52574,101570,93.1944
Portugal,2081,77,49531,53345,102876,92.8503
Portugal,2081,78,49255,53307,102562,92.3987
Portugal,2081,79,48200,52710,100910,91.4437
Portugal,2081,80,50656,56316,106972,89.9496
Portugal,2081,81,47950,54586,102536,87.843
Portugal,2081,82,45055,51957,97012,86.7159
Portugal,2081,83,42757,50789,93546,84.1856
Portugal,2081,84,40751,48323,89074,84.3304
Portugal,2081,85,38029,46406,84435,81.9485
Portugal,2081,86,35215,44599,79814,78.9592
Portugal,2081,87,33520,44471,77991,75.375
Portugal,2081,88,30768,42423,73191,72.5267
Portugal,2081,89,28244,40005,68249,70.6012
Portugal,2081,90,24861,36884,61745,67.4032
Portugal,2081,91,21367,33080,54447,64.5919
Portugal,2081,92,18357,29977,48334,61.2369
Portugal,2081,93,15324,26544,41868,57.7306
Portugal,2081,94,12657,23400,36057,54.0897
Portugal,2081,95,10248,20172,30420,50.8031
Portugal,2081,96,8299,17565,25864,47.2474
Portugal,2081,97,6212,14085,20297,44.1037
Portugal,2081,98,4568,11199,15767,40.7894
Portugal,2081,99,3110,8217,11327,37.8484
Portugal,2081,100,5232,16068,21300,32.5616
Portugal,2082,0,29686,27931,57617,106.2833
Portugal,2082,1,29978,28213,58191,106.256
Portugal,2082,2,30086,28316,58402,106.2509
Portugal,2082,3,30366,28581,58947,106.2454
Portugal,2082,4,30543,28745,59288,106.255
Portugal,2082,5,30824,29013,59837,106.242
Portugal,2082,6,31262,29430,60692,106.2249
Portugal,2082,7,31355,29517,60872,106.2269
Portugal,2082,8,31509,29664,61173,106.2197
Portugal,2082,9,31679,29826,61505,106.2127
Portugal,2082,10,31783,29926,61709,106.2053
Portugal,2082,11,31899,30034,61933,106.2096
Portugal,2082,12,32089,30214,62303,106.2057
Portugal,2082,13,32236,30358,62594,106.1862
Portugal,2082,14,32377,30496,62873,106.168
Portugal,2082,15,32419,30551,62970,106.1144
Portugal,2082,16,32582,30716,63298,106.075
Portugal,2082,17,32840,30981,63821,106.0005
Portugal,2082,18,33043,31193,64236,105.9308
Portugal,2082,19,33250,31412,64662,105.8513
Portugal,2082,20,33670,31835,65505,105.7641
Portugal,2082,21,33859,32040,65899,105.6773
Portugal,2082,22,34094,32290,66384,105.5869
Portugal,2082,23,34528,32727,67255,105.5031
Portugal,2082,24,34875,33075,67950,105.4422
Portugal,2082,25,35283,33488,68771,105.3601
Portugal,2082,26,35644,33853,69497,105.2905
Portugal,2082,27,36027,34233,70260,105.2406
Portugal,2082,28,36498,34694,71192,105.1997
Portugal,2082,29,36944,35132,72076,105.1577
Portugal,2082,30,37423,35601,73024,105.1178
Portugal,2082,31,37892,36062,73954,105.0746
Portugal,2082,32,38537,36674,75211,105.0799
Portugal,2082,33,39025,37149,76174,105.0499
Portugal,2082,34,39428,37538,76966,105.0349
Portugal,2082,35,39950,38044,77994,105.01
Portugal,2082,36,40293,38381,78674,104.9816
Portugal,2082,37,40757,38830,79587,104.9627
Portugal,2082,38,41288,39335,80623,104.965
Portugal,2082,39,41889,39916,81805,104.9429
Portugal,2082,40,42285,40302,82587,104.9204
Portugal,2082,41,42631,40648,83279,104.8785
Portugal,2082,42,43038,41048,84086,104.848
Portugal,2082,43,43330,41345,84675,104.8011
Portugal,2082,44,43432,41467,84899,104.7387
Portugal,2082,45,43773,41816,85589,104.68
Portugal,2082,46,44047,42101,86148,104.6222
Portugal,2082,47,44158,42245,86403,104.5283
Portugal,2082,48,44193,42318,86511,104.4307
Portugal,2082,49,43991,42175,86166,104.3059
Portugal,2082,50,44083,42317,86400,104.1733
Portugal,2082,51,43965,42277,86242,103.9927
Portugal,2082,52,43842,42229,86071,103.8197
Portugal,2082,53,43796,42272,86068,103.6052
Portugal,2082,54,43670,42246,85916,103.3707
Portugal,2082,55,43618,42296,85914,103.1256
Portugal,2082,56,43505,42303,85808,102.8414
Portugal,2082,57,43625,42545,86170,102.5385
Portugal,2082,58,43708,42768,86476,102.1979
Portugal,2082,59,43794,43013,86807,101.8157
Portugal,2082,60,43927,43322,87249,101.3965
Portugal,2082,61,45754,45180,90934,101.2705
Portugal,2082,62,46758,46312,93070,100.963
Portugal,2082,63,46312,46980,93292,98.5781
Portugal,2082,64,46005,46535,92540,98.8611
Portugal,2082,65,46498,46699,93197,99.5696
Portugal,2082,66,45354,46185,91539,98.2007
Portugal,2082,67,43932,44174,88106,99.4522
Portugal,2082,68,43453,44588,88041,97.4545
Portugal,2082,69,46627,47274,93901,98.6314
Portugal,2082,70,48912,50035,98947,97.7556
Portugal,2082,71,49646,52266,101912,94.9872
Portugal,2082,72,47865,50125,97990,95.4913
Portugal,2082,73,49523,51509,101032,96.1444
Portugal,2082,74,48059,50608,98667,94.9632
Portugal,2082,75,48555,51862,100417,93.6235
Portugal,2082,76,50126,53042,103168,94.5025
Portugal,2082,77,48487,52359,100846,92.6049
Portugal,2082,78,48948,53088,102036,92.2016
Portugal,2082,79,48577,52992,101569,91.6686
Portugal,2082,80,47407,52318,99725,90.6132
Portugal,2082,81,49615,55765,105380,88.9716
Portugal,2082,82,46768,53925,100693,86.7279
Portugal,2082,83,43766,51208,94974,85.4671
Portugal,2082,84,41312,49895,91207,82.7979
Portugal,2082,85,39107,47259,86366,82.7504
Portugal,2082,86,36141,45071,81212,80.1868
Portugal,2082,87,33101,42964,76065,77.0436
Portugal,2082,88,31144,42491,73635,73.2955
Portugal,2082,89,28087,40036,68123,70.1544
Portugal,2082,90,25320,37251,62571,67.9713
Portugal,2082,91,21878,33805,55683,64.7182
Portugal,2082,92,18480,29880,48360,61.8474
Portugal,2082,93,15670,26803,42473,58.4636
Portugal,2082,94,12771,23286,36057,54.8441
Portugal,2082,95,10207,19967,30174,51.1193
Portugal,2082,96,7969,16657,24626,47.8417
Portugal,2082,97,6230,14024,20254,44.4238
Portugal,2082,98,4494,10852,15346,41.4117
Portugal,2082,99,3173,8298,11471,38.2381
Portugal,2082,100,5210,16008,21218,32.5462
Portugal,2083,0,29477,27734,57211,106.2847
Portugal,2083,1,29750,27997,57747,106.2614
Portugal,2083,2,30034,28270,58304,106.2398
Portugal,2083,3,30134,28364,58498,106.2403
Portugal,2083,4,30407,28623,59030,106.2327
Portugal,2083,5,30578,28780,59358,106.2474
Portugal,2083,6,30854,29043,59897,106.2356
Portugal,2083,7,31287,29456,60743,106.2161
Portugal,2083,8,31377,29539,60916,106.2223
Portugal,2083,9,31528,29683,61211,106.2157
Portugal,2083,10,31696,29843,61539,106.2092
Portugal,2083,11,31799,29943,61742,106.1984
Portugal,2083,12,31918,30055,61973,106.1986
Portugal,2083,13,32116,30244,62360,106.1897
Portugal,2083,14,32276,30403,62679,106.1606
Portugal,2083,15,32434,30560,62994,106.1322
Portugal,2083,16,32497,30640,63137,106.0607
Portugal,2083,17,32684,30831,63515,106.0102
Portugal,2083,18,32965,31121,64086,105.9253
Portugal,2083,19,33189,31356,64545,105.8458
Portugal,2083,20,33413,31592,65005,105.7641
Portugal,2083,21,33847,32029,65876,105.6761
Portugal,2083,22,34045,32242,66287,105.5921
Portugal,2083,23,34284,32496,66780,105.5022
Portugal,2083,24,34719,32933,67652,105.4231
Portugal,2083,25,35064,33277,68341,105.3701
Portugal,2083,26,35467,33684,69151,105.2933
Portugal,2083,27,35821,34040,69861,105.2321
Portugal,2083,28,36196,34410,70606,105.1904
Portugal,2083,29,36657,34861,71518,105.1519
Portugal,2083,30,37093,35287,72380,105.118
Portugal,2083,31,37563,35745,73308,105.086
Portugal,2083,32,38022,36195,74217,105.0477
Portugal,2083,33,38657,36797,75454,105.0548
Portugal,2083,34,39135,37261,76396,105.0294
Portugal,2083,35,39527,37641,77168,105.0105
Portugal,2083,36,40041,38138,78179,104.9898
Portugal,2083,37,40376,38467,78843,104.9627
Portugal,2083,38,40830,38907,79737,104.9426
Portugal,2083,39,41352,39405,80757,104.941
Portugal,2083,40,41944,39978,81922,104.9177
Portugal,2083,41,42331,40357,82688,104.8913
Portugal,2083,42,42668,40696,83364,104.8457
Portugal,2083,43,43067,41090,84157,104.8114
Portugal,2083,44,43351,41382,84733,104.7581
Portugal,2083,45,43444,41498,84942,104.6894
Portugal,2083,46,43775,41841,85616,104.6223
Portugal,2083,47,44039,42120,86159,104.556
Portugal,2083,48,44141,42260,86401,104.451
Portugal,2083,49,44167,42328,86495,104.3446
Portugal,2083,50,43955,42181,86136,104.2057
Portugal,2083,51,44035,42318,86353,104.0574
Portugal,2083,52,43905,42273,86178,103.8606
Portugal,2083,53,43773,42221,85994,103.6759
Portugal,2083,54,43717,42260,85977,103.4477
Portugal,2083,55,43583,42231,85814,103.2014
Portugal,2083,56,43521,42277,85798,102.9425
Portugal,2083,57,43397,42281,85678,102.6395
Portugal,2083,58,43505,42519,86024,102.319
Portugal,2083,59,43575,42737,86312,101.9608
Portugal,2083,60,43646,42976,86622,101.559
Portugal,2083,61,43763,43279,87042,101.1183
Portugal,2083,62,45577,45134,90711,100.9815
Portugal,2083,63,46579,46266,92845,100.6765
Portugal,2083,64,46132,46930,93062,98.2996
Portugal,2083,65,45823,46484,92307,98.578
Portugal,2083,66,46310,46645,92955,99.2818
Portugal,2083,67,45160,46127,91287,97.9036
Portugal,2083,68,43731,44115,87846,99.1295
Portugal,2083,69,43232,44517,87749,97.1135
Portugal,2083,70,46376,47194,93570,98.2667
Portugal,2083,71,48629,49940,98569,97.3748
Portugal,2083,72,49333,52155,101488,94.5892
Portugal,2083,73,47546,50010,97556,95.073
Portugal,2083,74,49159,51375,100534,95.6866
Portugal,2083,75,47676,50463,98139,94.4771
Portugal,2083,76,48125,51691,99816,93.1013
Portugal,2083,77,49616,52833,102449,93.911
Portugal,2083,78,47929,52116,100045,91.966
Portugal,2083,79,48289,52785,101074,91.4824
Portugal,2083,80,47794,52611,100405,90.8441
Portugal,2083,81,46450,51821,98271,89.6355
Portugal,2083,82,48412,55109,103521,87.8477
Portugal,2083,83,45452,53170,98622,85.4843
Portugal,2083,84,42311,50331,92642,84.0655
Portugal,2083,85,39671,48824,88495,81.2531
Portugal,2083,86,37192,45932,83124,80.9719
Portugal,2083,87,33998,43454,77452,78.2391
Portugal,2083,88,30782,41090,71872,74.9136
Portugal,2083,89,28459,40143,68602,70.8941
Portugal,2083,90,25207,37324,62531,67.5356
Portugal,2083,91,22307,34184,56491,65.2557
Portugal,2083,92,18945,30577,49522,61.9583
Portugal,2083,93,15795,26757,42552,59.0313
Portugal,2083,94,13077,23552,36629,55.5239
Portugal,2083,95,10312,19903,30215,51.8113
Portugal,2083,96,7947,16516,24463,48.117
Portugal,2083,97,5990,13323,19313,44.9598
Portugal,2083,98,4513,10824,15337,41.6944
Portugal,2083,99,3125,8054,11179,38.8006
Portugal,2083,100,5244,16044,21288,32.6851
Portugal,2084,0,29324,27591,56915,106.281
Portugal,2084,1,29541,27800,57341,106.2626
Portugal,2084,2,29806,28054,57860,106.2451
Portugal,2084,3,30083,28319,58402,106.229
Portugal,2084,4,30175,28406,58581,106.2276
Portugal,2084,5,30442,28658,59100,106.2251
Portugal,2084,6,30608,28810,59418,106.2409
Portugal,2084,7,30879,29068,59947,106.2302
Portugal,2084,8,31309,29477,60786,106.215
Portugal,2084,9,31396,29557,60953,106.2219
Portugal,2084,10,31544,29700,61244,106.2088
Portugal,2084,11,31712,29860,61572,106.2023
Portugal,2084,12,31819,29964,61783,106.1908
Portugal,2084,13,31946,30085,62031,106.1858
Portugal,2084,14,32156,30288,62444,106.1675
Portugal,2084,15,32333,30467,62800,106.1247
Portugal,2084,16,32513,30649,63162,106.0818
Portugal,2084,17,32599,30755,63354,105.9958
Portugal,2084,18,32809,30971,63780,105.9346
Portugal,2084,19,33111,31283,64394,105.8434
Portugal,2084,20,33352,31536,64888,105.7585
Portugal,2084,21,33589,31786,65375,105.6723
Portugal,2084,22,34032,32231,66263,105.5878
Portugal,2084,23,34236,32448,66684,105.5104
Portugal,2084,24,34475,32701,67176,105.4249
Portugal,2084,25,34908,33134,68042,105.354
Portugal,2084,26,35248,33472,68720,105.3059
Portugal,2084,27,35644,33871,69515,105.2346
Portugal,2084,28,35989,34217,70206,105.1787
Portugal,2084,29,36355,34576,70931,105.1452
Portugal,2084,30,36806,35016,71822,105.1119
Portugal,2084,31,37233,35431,72664,105.0859
Portugal,2084,32,37693,35879,73572,105.0559
Portugal,2084,33,38142,36318,74460,105.0223
Portugal,2084,34,38766,36910,75676,105.0284
Portugal,2084,35,39234,37364,76598,105.0048
Portugal,2084,36,39618,37735,77353,104.9901
Portugal,2084,37,40124,38224,78348,104.9707
Portugal,2084,38,40450,38544,78994,104.945
Portugal,2084,39,40895,38977,79872,104.9209
Portugal,2084,40,41408,39467,80875,104.918
Portugal,2084,41,41990,40033,82023,104.8885
Portugal,2084,42,42369,40405,82774,104.8608
Portugal,2084,43,42698,40738,83436,104.8112
Portugal,2084,44,43088,41127,84215,104.7682
Portugal,2084,45,43363,41414,84777,104.7061
Portugal,2084,46,43447,41524,84971,104.6311
Portugal,2084,47,43769,41862,85631,104.5554
Portugal,2084,48,44022,42136,86158,104.476
Portugal,2084,49,44115,42271,86386,104.3623
Portugal,2084,50,44131,42334,86465,104.2448
Portugal,2084,51,43908,42183,86091,104.0893
Portugal,2084,52,43976,42315,86291,103.9253
Portugal,2084,53,43836,42266,86102,103.7146
Portugal,2084,54,43695,42210,85905,103.5181
Portugal,2084,55,43632,42246,85878,103.2808
Portugal,2084,56,43487,42214,85701,103.0156
Portugal,2084,57,43414,42256,85670,102.7404
Portugal,2084,58,43279,42256,85535,102.421
Portugal,2084,59,43375,42490,85865,102.0828
Portugal,2084,60,43430,42703,86133,101.7025
Portugal,2084,61,43486,42936,86422,101.281
Portugal,2084,62,43598,43237,86835,100.8349
Portugal,2084,63,45407,45091,90498,100.7008
Portugal,2084,64,46401,46219,92620,100.3938
Portugal,2084,65,45954,46880,92834,98.0247
Portugal,2084,66,45641,46432,92073,98.2964
Portugal,2084,67,46115,46589,92704,98.9826
Portugal,2084,68,44957,46067,91024,97.5905
Portugal,2084,69,43513,44048,87561,98.7854
Portugal,2084,70,43005,44444,87449,96.7622
Portugal,2084,71,46114,47108,93222,97.89
Portugal,2084,72,48329,49839,98168,96.9702
Portugal,2084,73,49011,52040,101051,94.1795
Portugal,2084,74,47204,49885,97089,94.6256
Portugal,2084,75,48776,51233,100009,95.2043
Portugal,2084,76,47263,50303,97566,93.9566
Portugal,2084,77,47646,51495,99141,92.5255
Portugal,2084,78,49057,52597,101654,93.2696
Portugal,2084,79,47296,51830,99126,91.2522
Portugal,2084,80,47525,52419,99944,90.6637
Portugal,2084,81,46846,52127,98973,89.869
Portugal,2084,82,45343,51231,96574,88.507
Portugal,2084,83,47071,54360,101431,86.5912
Portugal,2084,84,43963,52285,96248,84.0834
Portugal,2084,85,40653,49279,89932,82.4956
Portugal,2084,86,37753,47486,85239,79.5034
Portugal,2084,87,35012,44320,79332,78.9982
Portugal,2084,88,31642,41597,73239,76.068
Portugal,2084,89,28153,38860,67013,72.4472
Portugal,2084,90,25565,37467,63032,68.2334
Portugal,2084,91,22230,34294,56524,64.8218
Portugal,2084,92,19337,30962,50299,62.454
Portugal,2084,93,16211,27422,43633,59.1168
Portugal,2084,94,13197,23549,36746,56.0406
Portugal,2084,95,10573,20164,30737,52.435
Portugal,2084,96,8040,16492,24532,48.7509
Portugal,2084,97,5981,13233,19214,45.1976
Portugal,2084,98,4344,10301,14645,42.1707
Portugal,2084,99,3142,8047,11189,39.0456
Portugal,2084,100,5241,15915,21156,32.9312
Portugal,2085,0,29132,27410,56542,106.2824
Portugal,2085,1,29388,27657,57045,106.2588
Portugal,2085,2,29598,27858,57456,106.246
Portugal,2085,3,29855,28103,57958,106.2342
Portugal,2085,4,30124,28360,58484,106.22
Portugal,2085,5,30210,28441,58651,106.2199
Portugal,2085,6,30472,28688,59160,106.2186
Portugal,2085,7,30634,28836,59470,106.2353
Portugal,2085,8,30901,29090,59991,106.2255
Portugal,2085,9,31328,29496,60824,106.211
Portugal,2085,10,31412,29574,60986,106.2149
Portugal,2085,11,31561,29717,61278,106.2052
Portugal,2085,12,31732,29881,61613,106.1946
Portugal,2085,13,31846,29994,61840,106.1746
Portugal,2085,14,31985,30130,62115,106.1567
Portugal,2085,15,32213,30353,62566,106.1279
Portugal,2085,16,32412,30556,62968,106.0741
Portugal,2085,17,32615,30764,63379,106.0168
Portugal,2085,18,32724,30894,63618,105.9235
Portugal,2085,19,32954,31133,64087,105.8491
Portugal,2085,20,33274,31463,64737,105.756
Portugal,2085,21,33528,31730,65258,105.6666
Portugal,2085,22,33775,31988,65763,105.5865
Portugal,2085,23,34223,32437,66660,105.5061
Portugal,2085,24,34427,32653,67080,105.4329
Portugal,2085,25,34664,32903,67567,105.3521
Portugal,2085,26,35093,33330,68423,105.2895
Portugal,2085,27,35425,33659,69084,105.2467
Portugal,2085,28,35813,34048,69861,105.1839
Portugal,2085,29,36148,34383,70531,105.1334
Portugal,2085,30,36504,34732,71236,105.1019
Portugal,2085,31,36946,35161,72107,105.0766
Portugal,2085,32,37363,35565,72928,105.0555
Portugal,2085,33,37813,36002,73815,105.0303
Portugal,2085,34,38252,36431,74683,104.9985
Portugal,2085,35,38866,37013,75879,105.0063
Portugal,2085,36,39325,37459,76784,104.9814
Portugal,2085,37,39701,37821,77522,104.9708
Portugal,2085,38,40198,38301,78499,104.9529
Portugal,2085,39,40515,38614,79129,104.9231
Portugal,2085,40,40951,39039,79990,104.8977
Portugal,2085,41,41454,39522,80976,104.8884
Portugal,2085,42,42028,40082,82110,104.855
Portugal,2085,43,42399,40448,82847,104.8235
Portugal,2085,44,42719,40775,83494,104.7676
Portugal,2085,45,43101,41159,84260,104.7183
Portugal,2085,46,43367,41440,84807,104.6501
Portugal,2085,47,43442,41545,84987,104.5661
Portugal,2085,48,43753,41877,85630,104.4798
Portugal,2085,49,43998,42147,86145,104.3918
Portugal,2085,50,44081,42277,86358,104.2671
Portugal,2085,51,44085,42337,86422,104.1288
Portugal,2085,52,43851,42180,86031,103.9616
Portugal,2085,53,43909,42308,86217,103.7842
Portugal,2085,54,43761,42256,86017,103.5616
Portugal,2085,55,43612,42197,85809,103.3533
Portugal,2085,56,43538,42230,85768,103.0973
Portugal,2085,57,43383,42193,85576,102.8204
Portugal,2085,58,43299,42232,85531,102.5265
Portugal,2085,59,43152,42228,85380,102.1881
Portugal,2085,60,43234,42457,85691,101.8301
Portugal,2085,61,43274,42664,85938,101.4298
Portugal,2085,62,43326,42895,86221,101.0048
Portugal,2085,63,43439,43197,86636,100.5602
Portugal,2085,64,45238,45047,90285,100.424
Portugal,2085,65,46226,46172,92398,100.117
Portugal,2085,66,45775,46830,92605,97.7472
Portugal,2085,67,45454,46378,91832,98.0077
Portugal,2085,68,45912,46531,92443,98.6697
Portugal,2085,69,44738,46000,90738,97.2565
Portugal,2085,70,43291,43978,87269,98.4379
Portugal,2085,71,42768,44367,87135,96.396
Portugal,2085,72,45837,47015,92852,97.4944
Portugal,2085,73,48021,49733,97754,96.5576
Portugal,2085,74,48667,51914,100581,93.7454
Portugal,2085,75,46845,49752,96597,94.157
Portugal,2085,76,48363,51077,99440,94.6865
Portugal,2085,77,46804,50119,96923,93.3857
Portugal,2085,78,47122,51273,98395,91.9041
Portugal,2085,79,48424,52317,100741,92.5588
Portugal,2085,80,46564,51481,98045,90.4489
Portugal,2085,81,46601,51950,98551,89.7036
Portugal,2085,82,45750,51549,97299,88.7505
Portugal,2085,83,44110,50552,94662,87.2567
Portugal,2085,84,45557,53477,99034,85.1899
Portugal,2085,85,42269,51218,93487,82.5276
Portugal,2085,86,38718,47957,86675,80.7348
Portugal,2085,87,35570,45851,81421,77.5774
Portugal,2085,88,32617,42459,75076,76.82
Portugal,2085,89,28969,39374,68343,73.5739
Portugal,2085,90,25319,36306,61625,69.7378
Portugal,2085,91,22573,34464,57037,65.4973
Portugal,2085,92,19294,31100,50394,62.0386
Portugal,2085,93,16569,27805,44374,59.59
Portugal,2085,94,13564,24168,37732,56.1238
Portugal,2085,95,10686,20191,30877,52.9246
Portugal,2085,96,8254,16734,24988,49.3247
Portugal,2085,97,6059,13234,19293,45.7836
Portugal,2085,98,4343,10247,14590,42.3831
Portugal,2085,99,3028,7669,10697,39.4836
Portugal,2085,100,5251,15839,21090,33.1523
Portugal,2086,0,28747,27051,55798,106.2696
Portugal,2086,1,29196,27476,56672,106.26
Portugal,2086,2,29445,27714,57159,106.2459
Portugal,2086,3,29646,27906,57552,106.2352
Portugal,2086,4,29896,28144,58040,106.2251
Portugal,2086,5,30159,28395,58554,106.2124
Portugal,2086,6,30240,28471,58711,106.2133
Portugal,2086,7,30497,28713,59210,106.2132
Portugal,2086,8,30655,28858,59513,106.227
Portugal,2086,9,30920,29109,60029,106.2214
Portugal,2086,10,31344,29513,60857,106.204
Portugal,2086,11,31429,29592,61021,106.2078
Portugal,2086,12,31580,29738,61318,106.1941
Portugal,2086,13,31759,29911,61670,106.1783
Portugal,2086,14,31886,30039,61925,106.1487
Portugal,2086,15,32043,30195,62238,106.1202
Portugal,2086,16,32292,30442,62734,106.0771
Portugal,2086,17,32514,30671,63185,106.0089
Portugal,2086,18,32740,30903,63643,105.9444
Portugal,2086,19,32870,31057,63927,105.8377
Portugal,2086,20,33118,31313,64431,105.7644
Portugal,2086,21,33450,31657,65107,105.6638
Portugal,2086,22,33714,31932,65646,105.5806
Portugal,2086,23,33966,32194,66160,105.5041
Portugal,2086,24,34414,32642,67056,105.4286
Portugal,2086,25,34616,32855,67471,105.3599
Portugal,2086,26,34848,33099,67947,105.2841
Portugal,2086,27,35270,33517,68787,105.2302
Portugal,2086,28,35593,33837,69430,105.1896
Portugal,2086,29,35972,34214,70186,105.1382
Portugal,2086,30,36298,34539,70837,105.0928
Portugal,2086,31,36644,34876,71520,105.0694
Portugal,2086,32,37076,35294,72370,105.049
Portugal,2086,33,37483,35688,73171,105.0297
Portugal,2086,34,37923,36115,74038,105.0062
Portugal,2086,35,38352,36535,74887,104.9733
Portugal,2086,36,38958,37108,76066,104.9854
Portugal,2086,37,39409,37545,76954,104.9647
Portugal,2086,38,39776,37899,77675,104.9526
Portugal,2086,39,40264,38371,78635,104.9334
Portugal,2086,40,40571,38676,79247,104.8997
Portugal,2086,41,40999,39094,80093,104.8729
Portugal,2086,42,41494,39571,81065,104.8596
Portugal,2086,43,42059,40125,82184,104.8199
Portugal,2086,44,42421,40485,82906,104.782
Portugal,2086,45,42734,40808,83542,104.7197
Portugal,2086,46,43106,41186,84292,104.6618
Portugal,2086,47,43362,41461,84823,104.585
Portugal,2086,48,43428,41561,84989,104.4922
Portugal,2086,49,43730,41889,85619,104.3949
Portugal,2086,50,43965,42154,86119,104.2962
Portugal,2086,51,44036,42280,86316,104.1533
Portugal,2086,52,44029,42335,86364,104.0014
Portugal,2086,53,43786,42174,85960,103.8223
Portugal,2086,54,43835,42299,86134,103.6313
Portugal,2086,55,43678,42244,85922,103.3946
Portugal,2086,56,43520,42182,85702,103.172
Portugal,2086,57,43436,42210,85646,102.9045
Portugal,2086,58,43270,42171,85441,102.6061
Portugal,2086,59,43174,42206,85380,102.2935
Portugal,2086,60,43014,42196,85210,101.9386
Portugal,2086,61,43081,42419,85500,101.5606
Portugal,2086,62,43117,42625,85742,101.1543
Portugal,2086,63,43171,42858,86029,100.7303
Portugal,2086,64,43281,43157,86438,100.2873
Portugal,2086,65,45070,45003,90073,100.1489
Portugal,2086,66,46050,46124,92174,99.8396
Portugal,2086,67,45591,46778,92369,97.4625
Portugal,2086,68,45259,46322,91581,97.7052
Portugal,2086,69,45694,46465,92159,98.3407
Portugal,2086,70,44514,45930,90444,96.917
Portugal,2086,71,43057,43904,86961,98.0708
Portugal,2086,72,42517,44283,86800,96.012
Portugal,2086,73,45551,46920,92471,97.0823
Portugal,2086,74,47691,49618,97309,96.1163
Portugal,2086,75,48305,51781,100086,93.2871
Portugal,2086,76,46458,49606,96064,93.654
Portugal,2086,77,47904,50897,98801,94.1195
Portugal,2086,78,46301,49911,96212,92.7671
Portugal,2086,79,46528,51010,97538,91.2135
Portugal,2086,80,47690,51978,99668,91.7504
Portugal,2086,81,45676,51036,96712,89.4976
Portugal,2086,82,45530,51391,96921,88.5953
Portugal,2086,83,44528,50886,95414,87.5054
Portugal,2086,84,42715,49754,92469,85.8524
Portugal,2086,85,43829,52414,96243,83.6208
Portugal,2086,86,40285,49875,90160,80.7719
Portugal,2086,87,36508,46341,82849,78.7812
Portugal,2086,88,33166,43965,77131,75.4373
Portugal,2086,89,29891,40231,70122,74.2984
Portugal,2086,90,26081,36829,62910,70.8165
Portugal,2086,91,22380,33438,55818,66.9298
Portugal,2086,92,19614,31296,50910,62.6725
Portugal,2086,93,16553,27969,44522,59.1834
Portugal,2086,94,13882,24544,38426,56.5596
Portugal,2086,95,10998,20757,31755,52.9845
Portugal,2086,96,8354,16785,25139,49.7706
Portugal,2086,97,6229,13451,19680,46.3088
Portugal,2086,98,4406,10266,14672,42.9184
Portugal,2086,99,3032,7642,10674,39.6755
Portugal,2086,100,5191,15540,20731,33.4041
Portugal,2087,0,28613,26923,55536,106.2772
Portugal,2087,1,28812,27117,55929,106.2507
Portugal,2087,2,29253,27533,56786,106.247
Portugal,2087,3,29493,27763,57256,106.2313
Portugal,2087,4,29688,27948,57636,106.2258
Portugal,2087,5,29931,28179,58110,106.2174
Portugal,2087,6,30189,28425,58614,106.2058
Portugal,2087,7,30266,28496,58762,106.2114
Portugal,2087,8,30519,28735,59254,106.2085
Portugal,2087,9,30674,28876,59550,106.2266
Portugal,2087,10,30936,29126,60062,106.2144
Portugal,2087,11,31361,29530,60891,106.2005
Portugal,2087,12,31449,29613,61062,106.2
Portugal,2087,13,31607,29768,61375,106.1778
Portugal,2087,14,31799,29956,61755,106.1524
Portugal,2087,15,31943,30104,62047,106.1088
Portugal,2087,16,32121,30284,62405,106.0659
Portugal,2087,17,32394,30557,62951,106.0117
Portugal,2087,18,32639,30811,63450,105.9329
Portugal,2087,19,32886,31066,63952,105.8585
Portugal,2087,20,33033,31237,64270,105.7496
Portugal,2087,21,33294,31507,64801,105.6718
Portugal,2087,22,33636,31859,65495,105.5777
Portugal,2087,23,33905,32138,66043,105.4982
Portugal,2087,24,34157,32400,66557,105.4228
Portugal,2087,25,34603,32844,67447,105.3556
Portugal,2087,26,34800,33050,67850,105.295
Portugal,2087,27,35026,33286,68312,105.2274
Portugal,2087,28,35438,33694,69132,105.176
Portugal,2087,29,35753,34003,69756,105.1466
Portugal,2087,30,36121,34370,70491,105.0946
Portugal,2087,31,36438,34683,71121,105.0601
Portugal,2087,32,36774,35010,71784,105.0386
Portugal,2087,33,37197,35418,72615,105.0229
Portugal,2087,34,37593,35801,73394,105.0054
Portugal,2087,35,38023,36218,74241,104.9837
Portugal,2087,36,38444,36629,75073,104.9551
Portugal,2087,37,39041,37194,76235,104.9659
Portugal,2087,38,39484,37622,77106,104.9492
Portugal,2087,39,39842,37969,77811,104.933
Portugal,2087,40,40320,38434,78754,104.9071
Portugal,2087,41,40619,38732,79351,104.8719
Portugal,2087,42,41038,39144,80182,104.8385
Portugal,2087,43,41525,39614,81139,104.8241
Portugal,2087,44,42083,40163,82246,104.7805
Portugal,2087,45,42436,40518,82954,104.7337
Portugal,2087,46,42740,40835,83575,104.6651
Portugal,2087,47,43102,41208,84310,104.5962
Portugal,2087,48,43349,41478,84827,104.5108
Portugal,2087,49,43406,41573,84979,104.4091
Portugal,2087,50,43699,41897,85596,104.301
Portugal,2087,51,43922,42157,86079,104.1867
Portugal,2087,52,43982,42279,86261,104.028
Portugal,2087,53,43965,42329,86294,103.865
Portugal,2087,54,43713,42166,85879,103.6688
Portugal,2087,55,43754,42287,86041,103.4692
Portugal,2087,56,43588,42228,85816,103.2206
Portugal,2087,57,43419,42163,85582,102.9789
Portugal,2087,58,43325,42189,85514,102.6926
Portugal,2087,59,43147,42145,85292,102.3775
Portugal,2087,60,43039,42175,85214,102.0486
Portugal,2087,61,42866,42160,85026,101.6746
Portugal,2087,62,42928,42382,85310,101.2883
Portugal,2087,63,42966,42589,85555,100.8852
Portugal,2087,64,43017,42819,85836,100.4624
Portugal,2087,65,43125,43117,86242,100.0186
Portugal,2087,66,44903,44959,89862,99.8754
Portugal,2087,67,45869,46075,91944,99.5529
Portugal,2087,68,45400,46723,92123,97.1684
Portugal,2087,69,45048,46259,91307,97.3821
Portugal,2087,70,45470,46397,91867,98.002
Portugal,2087,71,44279,45855,90134,96.5631
Portugal,2087,72,42810,43825,86635,97.684
Portugal,2087,73,42259,44197,86456,95.6151
Portugal,2087,74,45247,46815,92062,96.6506
Portugal,2087,75,47346,49495,96841,95.6581
Portugal,2087,76,47916,51635,99551,92.7975
Portugal,2087,77,46027,49437,95464,93.1023
Portugal,2087,78,47401,50693,98094,93.506
Portugal,2087,79,45730,49664,95394,92.0788
Portugal,2087,80,45837,50689,96526,90.4279
Portugal,2087,81,46797,51541,98338,90.7957
Portugal,2087,82,44645,50501,95146,88.4042
Portugal,2087,83,44335,50747,95082,87.3648
Portugal,2087,84,43143,50103,93246,86.1086
Portugal,2087,85,41120,48789,89909,84.2813
Portugal,2087,86,41800,51070,92870,81.8484
Portugal,2087,87,38015,48228,86243,78.8235
Portugal,2087,88,34069,44470,78539,76.6112
Portugal,2087,89,30423,41695,72118,72.9656
Portugal,2087,90,26939,37667,64606,71.5188
Portugal,2087,91,23079,33956,57035,67.9674
Portugal,2087,92,19470,30400,49870,64.0461
Portugal,2087,93,16849,28182,45031,59.7864
Portugal,2087,94,13887,24724,38611,56.1681
Portugal,2087,95,11271,21110,32381,53.3918
Portugal,2087,96,8610,17281,25891,49.8235
Portugal,2087,97,6313,13513,19826,46.718
Portugal,2087,98,4536,10450,14986,43.4067
Portugal,2087,99,3079,7667,10746,40.1591
Portugal,2087,100,5154,15339,20493,33.6006
Portugal,2088,0,28449,26767,55216,106.2839
Portugal,2088,1,28677,26989,55666,106.2544
Portugal,2088,2,28869,27174,56043,106.2376
Portugal,2088,3,29301,27582,56883,106.2323
Portugal,2088,4,29535,27804,57339,106.2257
Portugal,2088,5,29723,27983,57706,106.2181
Portugal,2088,6,29961,28209,58170,106.2108
Portugal,2088,7,30214,28451,58665,106.1966
Portugal,2088,8,30287,28518,58805,106.2031
Portugal,2088,9,30538,28754,59292,106.2044
Portugal,2088,10,30691,28893,59584,106.223
Portugal,2088,11,30953,29143,60096,106.2108
Portugal,2088,12,31380,29552,60932,106.1857
Portugal,2088,13,31476,29643,61119,106.1836
Portugal,2088,14,31647,29813,61460,106.1517
Portugal,2088,15,31856,30021,61877,106.1124
Portugal,2088,16,32022,30193,62215,106.0577
Portugal,2088,17,32223,30398,62621,106.0037
Portugal,2088,18,32519,30697,63216,105.9354
Portugal,2088,19,32785,30973,63758,105.8503
Portugal,2088,20,33049,31246,64295,105.7703
Portugal,2088,21,33210,31431,64641,105.66
Portugal,2088,22,33480,31709,65189,105.5852
Portugal,2088,23,33827,32065,65892,105.4951
Portugal,2088,24,34096,32343,66439,105.42
Portugal,2088,25,34347,32601,66948,105.3557
Portugal,2088,26,34788,33039,67827,105.2937
Portugal,2088,27,34978,33237,68215,105.2381
Portugal,2088,28,35195,33463,68658,105.1759
Portugal,2088,29,35598,33861,69459,105.1298
Portugal,2088,30,35903,34159,70062,105.1055
Portugal,2088,31,36262,34515,70777,105.0616
Portugal,2088,32,36569,34817,71386,105.032
Portugal,2088,33,36895,35134,72029,105.0122
Portugal,2088,34,37307,35531,72838,104.9985
Portugal,2088,35,37694,35905,73599,104.9826
Portugal,2088,36,38115,36313,74428,104.9624
Portugal,2088,37,38528,36715,75243,104.938
Portugal,2088,38,39116,37272,76388,104.9474
Portugal,2088,39,39550,37693,77243,104.9266
Portugal,2088,40,39899,38032,77931,104.909
Portugal,2088,41,40369,38490,78859,104.8818
Portugal,2088,42,40659,38781,79440,104.8426
Portugal,2088,43,41071,39187,80258,104.8077
Portugal,2088,44,41549,39652,81201,104.7841
Portugal,2088,45,42098,40196,82294,104.7318
Portugal,2088,46,42443,40546,82989,104.6786
Portugal,2088,47,42737,40857,83594,104.6014
Portugal,2088,48,43090,41225,84315,104.524
Portugal,2088,49,43329,41491,84820,104.4299
Portugal,2088,50,43376,41582,84958,104.3144
Portugal,2088,51,43657,41901,85558,104.1908
Portugal,2088,52,43869,42157,86026,104.061
Portugal,2088,53,43919,42275,86194,103.8888
Portugal,2088,54,43894,42322,86216,103.7144
Portugal,2088,55,43635,42155,85790,103.5109
Portugal,2088,56,43666,42273,85939,103.2952
Portugal,2088,57,43490,42211,85701,103.03
Portugal,2088,58,43311,42142,85453,102.774
Portugal,2088,59,43204,42164,85368,102.4666
Portugal,2088,60,43015,42115,85130,102.137
Portugal,2088,61,42893,42140,85033,101.7869
Portugal,2088,62,42716,42125,84841,101.403
Portugal,2088,63,42781,42348,85129,101.0225
Portugal,2088,64,42817,42552,85369,100.6228
Portugal,2088,65,42865,42781,85646,100.1963
Portugal,2088,66,42969,43076,86045,99.7516
Portugal,2088,67,44731,44913,89644,99.5948
Portugal,2088,68,45682,46024,91706,99.2569
Portugal,2088,69,45194,46662,91856,96.854
Portugal,2088,70,44833,46194,91027,97.0537
Portugal,2088,71,45236,46324,91560,97.6513
Portugal,2088,72,44031,45775,89806,96.1901
Portugal,2088,73,42557,43742,86299,97.2909
Portugal,2088,74,41984,44102,86086,95.1975
Portugal,2088,75,44927,46704,91631,96.1952
Portugal,2088,76,46974,49361,96335,95.1642
Portugal,2088,77,47483,51466,98949,92.2609
Portugal,2088,78,45556,49247,94803,92.5051
Portugal,2088,79,46830,50451,97281,92.8227
Portugal,2088,80,45066,49362,94428,91.2969
Portugal,2088,81,44997,50277,95274,89.4982
Portugal,2088,82,45762,51017,96779,89.6995
Portugal,2088,83,43496,49887,93383,87.189
Portugal,2088,84,42980,49988,92968,85.9806
Portugal,2088,85,41559,49156,90715,84.5451
Portugal,2088,86,39246,47568,86814,82.505
Portugal,2088,87,39478,49420,88898,79.8826
Portugal,2088,88,35509,46321,81830,76.6585
Portugal,2088,89,31284,42215,73499,74.1064
Portugal,2088,90,27449,39081,66530,70.2362
Portugal,2088,91,23866,34771,58637,68.6377
Portugal,2088,92,20103,30912,51015,65.033
Portugal,2088,93,16748,27415,44163,61.0906
Portugal,2088,94,14156,24951,39107,56.7352
Portugal,2088,95,11292,21300,32592,53.0141
Portugal,2088,96,8836,17605,26441,50.1903
Portugal,2088,97,6515,13937,20452,46.7461
Portugal,2088,98,4603,10516,15119,43.7714
Portugal,2088,99,3174,7818,10992,40.5986
Portugal,2088,100,5170,15242,20412,33.9194
Portugal,2089,0,28244,26568,54812,106.3083
Portugal,2089,1,28514,26834,55348,106.2607
Portugal,2089,2,28734,27046,55780,106.2412
Portugal,2089,3,28917,27223,56140,106.2227
Portugal,2089,4,29342,27623,56965,106.2231
Portugal,2089,5,29570,27840,57410,106.2141
Portugal,2089,6,29753,28013,57766,106.2114
Portugal,2089,7,29987,28235,58222,106.2051
Portugal,2089,8,30236,28472,58708,106.1956
Portugal,2089,9,30306,28537,58843,106.199
Portugal,2089,10,30554,28771,59325,106.1972
Portugal,2089,11,30707,28911,59618,106.2122
Portugal,2089,12,30973,29164,60137,106.2029
Portugal,2089,13,31408,29582,60990,106.1727
Portugal,2089,14,31516,29688,61204,106.1574
Portugal,2089,15,31705,29878,61583,106.1149
Portugal,2089,16,31935,30110,62045,106.0611
Portugal,2089,17,32124,30307,62431,105.9953
Portugal,2089,18,32349,30538,62887,105.9303
Portugal,2089,19,32665,30859,63524,105.8524
Portugal,2089,20,32948,31153,64101,105.7619
Portugal,2089,21,33226,31440,64666,105.6807
Portugal,2089,22,33396,31633,65029,105.5733
Portugal,2089,23,33671,31915,65586,105.5021
Portugal,2089,24,34019,32270,66289,105.4199
Portugal,2089,25,34286,32545,66831,105.3495
Portugal,2089,26,34531,32797,67328,105.2871
Portugal,2089,27,34965,33227,68192,105.2307
Portugal,2089,28,35147,33415,68562,105.1833
Portugal,2089,29,35354,33630,68984,105.1264
Portugal,2089,30,35748,34016,69764,105.0917
Portugal,2089,31,36043,34303,70346,105.0724
Portugal,2089,32,36392,34649,71041,105.0304
Portugal,2089,33,36690,34941,71631,105.0056
Portugal,2089,34,37006,35247,72253,104.9905
Portugal,2089,35,37408,35635,73043,104.9754
Portugal,2089,36,37786,36000,73786,104.9611
Portugal,2089,37,38199,36399,74598,104.9452
Portugal,2089,38,38603,36794,75397,104.9166
Portugal,2089,39,39183,37342,76525,104.9301
Portugal,2089,40,39607,37756,77363,104.9025
Portugal,2089,41,39948,38088,78036,104.8834
Portugal,2089,42,40410,38539,78949,104.8548
Portugal,2089,43,40692,38825,79517,104.8088
Portugal,2089,44,41096,39226,80322,104.7672
Portugal,2089,45,41566,39686,81252,104.7372
Portugal,2089,46,42106,40224,82330,104.6788
Portugal,2089,47,42442,40568,83010,104.6194
Portugal,2089,48,42726,40875,83601,104.5284
Portugal,2089,49,43071,41238,84309,104.4449
Portugal,2089,50,43300,41500,84800,104.3373
Portugal,2089,51,43336,41587,84923,104.2056
Portugal,2089,52,43606,41902,85508,104.0666
Portugal,2089,53,43808,42153,85961,103.9262
Portugal,2089,54,43850,42268,86118,103.7428
Portugal,2089,55,43816,42312,86128,103.5545
Portugal,2089,56,43548,42142,85690,103.3363
Portugal,2089,57,43569,42256,85825,103.1073
Portugal,2089,58,43383,42191,85574,102.8252
Portugal,2089,59,43193,42119,85312,102.5499
Portugal,2089,60,43074,42135,85209,102.2286
Portugal,2089,61,42871,42082,84953,101.8749
Portugal,2089,62,42746,42106,84852,101.52
Portugal,2089,63,42572,42092,84664,101.1404
Portugal,2089,64,42635,42313,84948,100.761
Portugal,2089,65,42669,42516,85185,100.3599
Portugal,2089,66,42713,42742,85455,99.9322
Portugal,2089,67,42808,43034,85842,99.4748
Portugal,2089,68,44552,44865,89417,99.3024
Portugal,2089,69,45478,45966,91444,98.9383
Portugal,2089,70,44982,46599,91581,96.53
Portugal,2089,71,44607,46125,90732,96.7089
Portugal,2089,72,44988,46246,91234,97.2798
Portugal,2089,73,43776,45692,89468,95.8067
Portugal,2089,74,42286,43653,85939,96.8685
Portugal,2089,75,41694,44002,85696,94.7548
Portugal,2089,76,44582,46583,91165,95.7044
Portugal,2089,77,46558,49206,95764,94.6185
Portugal,2089,78,47006,51275,98281,91.6743
Portugal,2089,79,45018,49021,94039,91.8341
Portugal,2089,80,46163,50156,96319,92.0388
Portugal,2089,81,44254,48973,93227,90.3641
Portugal,2089,82,44017,49781,93798,88.4213
Portugal,2089,83,44602,50415,95017,88.4697
Portugal,2089,84,42186,49162,91348,85.8102
Portugal,2089,85,41425,49069,90494,84.4219
Portugal,2089,86,39690,47955,87645,82.7651
Portugal,2089,87,37091,46064,83155,80.5206
Portugal,2089,88,36903,47505,84408,77.6823
Portugal,2089,89,32633,44013,76646,74.144
Portugal,2089,90,28252,39611,67863,71.3236
Portugal,2089,91,24342,36119,60461,67.3939
Portugal,2089,92,20809,31695,52504,65.6539
Portugal,2089,93,17311,27917,45228,62.0088
Portugal,2089,94,14087,24309,38396,57.9497
Portugal,2089,95,11524,21530,33054,53.5253
Portugal,2089,96,8863,17793,26656,49.8117
Portugal,2089,97,6695,14222,20917,47.075
Portugal,2089,98,4756,10864,15620,43.7776
Portugal,2089,99,3225,7881,11106,40.9212
Portugal,2089,100,5248,15317,20565,34.2626
Portugal,2090,0,28031,26364,54395,106.323
Portugal,2090,1,28308,26635,54943,106.2812
Portugal,2090,2,28571,26891,55462,106.2474
Portugal,2090,3,28783,27095,55878,106.2299
Portugal,2090,4,28958,27264,56222,106.2133
Portugal,2090,5,29377,27659,57036,106.2114
Portugal,2090,6,29600,27870,57470,106.2074
Portugal,2090,7,29778,28038,57816,106.2059
Portugal,2090,8,30008,28256,58264,106.2005
Portugal,2090,9,30255,28491,58746,106.1914
Portugal,2090,10,30323,28554,58877,106.1953
Portugal,2090,11,30571,28788,59359,106.1936
Portugal,2090,12,30727,28932,59659,106.2042
Portugal,2090,13,31000,29194,60194,106.1862
Portugal,2090,14,31448,29626,61074,106.15
Portugal,2090,15,31573,29752,61325,106.1206
Portugal,2090,16,31783,29967,61750,106.06
Portugal,2090,17,32037,30224,62261,105.9985
Portugal,2090,18,32250,30447,62697,105.9218
Portugal,2090,19,32495,30700,63195,105.8469
Portugal,2090,20,32828,31039,63867,105.7637
Portugal,2090,21,33125,31347,64472,105.672
Portugal,2090,22,33412,31642,65054,105.5938
Portugal,2090,23,33587,31839,65426,105.4901
Portugal,2090,24,33863,32121,65984,105.4232
Portugal,2090,25,34208,32472,66680,105.3461
Portugal,2090,26,34471,32741,67212,105.2839
Portugal,2090,27,34709,32984,67693,105.2298
Portugal,2090,28,35134,33404,68538,105.179
Portugal,2090,29,35306,33581,68887,105.1368
Portugal,2090,30,35504,33785,69289,105.0881
Portugal,2090,31,35888,34161,70049,105.0555
Portugal,2090,32,36174,34438,70612,105.0409
Portugal,2090,33,36514,34772,71286,105.0098
Portugal,2090,34,36800,35054,71854,104.9809
Portugal,2090,35,37107,35351,72458,104.9673
Portugal,2090,36,37500,35730,73230,104.9538
Portugal,2090,37,37871,36086,73957,104.9465
Portugal,2090,38,38275,36478,74753,104.9263
Portugal,2090,39,38670,36864,75534,104.8991
Portugal,2090,40,39241,37405,76646,104.9084
Portugal,2090,41,39657,37812,77469,104.8794
Portugal,2090,42,39989,38138,78127,104.8534
Portugal,2090,43,40443,38584,79027,104.8181
Portugal,2090,44,40718,38865,79583,104.7678
Portugal,2090,45,41113,39260,80373,104.7198
Portugal,2090,46,41575,39714,81289,104.686
Portugal,2090,47,42106,40247,82353,104.619
Portugal,2090,48,42432,40587,83019,104.5458
Portugal,2090,49,42708,40889,83597,104.4486
Portugal,2090,50,43043,41248,84291,104.3517
Portugal,2090,51,43261,41506,84767,104.2283
Portugal,2090,52,43287,41588,84875,104.0853
Portugal,2090,53,43547,41899,85446,103.9333
Portugal,2090,54,43740,42147,85887,103.7796
Portugal,2090,55,43774,42259,86033,103.585
Portugal,2090,56,43731,42299,86030,103.3854
Portugal,2090,57,43454,42126,85580,103.1524
Portugal,2090,58,43464,42237,85701,102.905
Portugal,2090,59,43267,42168,85435,102.6062
Portugal,2090,60,43065,42091,85156,102.314
Portugal,2090,61,42933,42103,85036,101.9714
Portugal,2090,62,42727,42049,84776,101.6124
Portugal,2090,63,42605,42075,84680,101.2597
Portugal,2090,64,42430,42059,84489,100.8821
Portugal,2090,65,42491,42278,84769,100.5038
Portugal,2090,66,42521,42479,85000,100.0989
Portugal,2090,67,42557,42702,85259,99.6604
Portugal,2090,68,42641,42990,85631,99.1882
Portugal,2090,69,44358,44811,89169,98.9891
Portugal,2090,70,45270,45906,91176,98.6146
Portugal,2090,71,44761,46532,91293,96.194
Portugal,2090,72,44368,46050,90418,96.3474
Portugal,2090,73,44734,46166,90900,96.8982
Portugal,2090,74,43504,45602,89106,95.3993
Portugal,2090,75,42002,43558,85560,96.4278
Portugal,2090,76,41382,43892,85274,94.2814
Portugal,2090,77,44198,46442,90640,95.1682
Portugal,2090,78,46102,49031,95133,94.0262
Portugal,2090,79,46464,51048,97512,91.0202
Portugal,2090,80,44392,48744,93136,91.0717
Portugal,2090,81,45348,49773,95121,91.1096
Portugal,2090,82,43310,48505,91815,89.2898
Portugal,2090,83,42923,49211,92134,87.2224
Portugal,2090,84,43284,49703,92987,87.0853
Portugal,2090,85,40686,48282,88968,84.2674
Portugal,2090,86,39591,47899,87490,82.6552
Portugal,2090,87,37540,46473,84013,80.7781
Portugal,2090,88,34704,44317,79021,78.3085
Portugal,2090,89,33949,45181,79130,75.14
Portugal,2090,90,29504,41343,70847,71.364
Portugal,2090,91,25084,36652,61736,68.4383
Portugal,2090,92,21251,32966,54217,64.4634
Portugal,2090,93,17944,28665,46609,62.599
Portugal,2090,94,14582,24791,39373,58.8197
Portugal,2090,95,11484,21010,32494,54.6597
Portugal,2090,96,9059,18015,27074,50.2859
Portugal,2090,97,6725,14398,21123,46.7079
Portugal,2090,98,4894,11106,16000,44.0663
Portugal,2090,99,3336,8155,11491,40.9074
Portugal,2090,100,5339,15436,20775,34.588
Portugal,2091,0,27773,26122,53895,106.3203
Portugal,2091,1,28095,26431,54526,106.2956
Portugal,2091,2,28365,26692,55057,106.2678
Portugal,2091,3,28619,26940,55559,106.2324
Portugal,2091,4,28824,27137,55961,106.2166
Portugal,2091,5,28993,27300,56293,106.2015
Portugal,2091,6,29407,27689,57096,106.2046
Portugal,2091,7,29625,27895,57520,106.2018
Portugal,2091,8,29800,28060,57860,106.201
Portugal,2091,9,30027,28275,58302,106.1963
Portugal,2091,10,30272,28508,58780,106.1877
Portugal,2091,11,30339,28571,58910,106.1881
Portugal,2091,12,30591,28809,59400,106.1856
Portugal,2091,13,30754,28962,59716,106.1874
Portugal,2091,14,31040,29239,60279,106.1596
Portugal,2091,15,31505,29691,61196,106.1096
Portugal,2091,16,31652,29841,61493,106.0688
Portugal,2091,17,31886,30081,61967,106.0005
Portugal,2091,18,32162,30364,62526,105.9215
Portugal,2091,19,32396,30609,63005,105.8382
Portugal,2091,20,32658,30881,63539,105.7543
Portugal,2091,21,33005,31233,64238,105.6735
Portugal,2091,22,33312,31550,64862,105.5848
Portugal,2091,23,33603,31848,65451,105.5106
Portugal,2091,24,33779,32045,65824,105.4111
Portugal,2091,25,34053,32323,66376,105.3522
Portugal,2091,26,34393,32668,67061,105.2804
Portugal,2091,27,34648,32928,67576,105.2235
Portugal,2091,28,34878,33162,68040,105.1746
Portugal,2091,29,35294,33571,68865,105.1324
Portugal,2091,30,35457,33737,69194,105.0983
Portugal,2091,31,35645,33930,69575,105.0545
Portugal,2091,32,36019,34295,70314,105.027
Portugal,2091,33,36295,34561,70856,105.0172
Portugal,2091,34,36624,34886,71510,104.9819
Portugal,2091,35,36902,35158,72060,104.9605
Portugal,2091,36,37200,35446,72646,104.9484
Portugal,2091,37,37585,35816,73401,104.9391
Portugal,2091,38,37947,36165,74112,104.9274
Portugal,2091,39,38342,36548,74890,104.9086
Portugal,2091,40,38728,36928,75656,104.8744
Portugal,2091,41,39291,37462,76753,104.8823
Portugal,2091,42,39699,37862,77561,104.8518
Portugal,2091,43,40023,38183,78206,104.8189
Portugal,2091,44,40469,38623,79092,104.7795
Portugal,2091,45,40736,38899,79635,104.7225
Portugal,2091,46,41123,39289,80412,104.668
Portugal,2091,47,41576,39738,81314,104.6253
Portugal,2091,48,42097,40266,82363,104.5473
Portugal,2091,49,42415,40601,83016,104.4679
Portugal,2091,50,42682,40900,83582,104.357
Portugal,2091,51,43007,41255,84262,104.2468
Portugal,2091,52,43214,41508,84722,104.1101
Portugal,2091,53,43230,41586,84816,103.9533
Portugal,2091,54,43482,41893,85375,103.793
Portugal,2091,55,43667,42139,85806,103.6261
Portugal,2091,56,43691,42247,85938,103.418
Portugal,2091,57,43638,42284,85922,103.2022
Portugal,2091,58,43351,42108,85459,102.9519
Portugal,2091,59,43350,42216,85566,102.6862
Portugal,2091,60,43141,42142,85283,102.3706
Portugal,2091,61,42926,42060,84986,102.059
Portugal,2091,62,42792,42072,84864,101.7114
Portugal,2091,63,42590,42019,84609,101.3589
Portugal,2091,64,42466,42043,84509,101.0061
Portugal,2091,65,42291,42026,84317,100.6306
Portugal,2091,66,42347,42243,84590,100.2462
Portugal,2091,67,42370,42441,84811,99.8327
Portugal,2091,68,42395,42661,85056,99.3765
Portugal,2091,69,42460,42941,85401,98.8799
Portugal,2091,70,44161,44755,88916,98.6728
Portugal,2091,71,45053,45843,90896,98.2767
Portugal,2091,72,44528,46460,90988,95.8416
Portugal,2091,73,44124,45974,90098,95.976
Portugal,2091,74,44463,46079,90542,96.493
Portugal,2091,75,43219,45508,88727,94.9701
Portugal,2091,76,41696,43454,85150,95.9543
Portugal,2091,77,41035,43766,84801,93.76
Portugal,2091,78,43776,46284,90060,94.5813
Portugal,2091,79,45584,48823,94407,93.3658
Portugal,2091,80,45833,50771,96604,90.274
Portugal,2091,81,43625,48385,92010,90.1622
Portugal,2091,82,44399,49313,93712,90.0351
Portugal,2091,83,42253,47968,90221,88.0858
Portugal,2091,84,41677,48538,90215,85.8647
Portugal,2091,85,41770,48839,90609,85.5259
Portugal,2091,86,38912,47162,86074,82.5071
Portugal,2091,87,37477,46455,83932,80.6738
Portugal,2091,88,35157,44750,79907,78.5631
Portugal,2091,89,31958,42192,74150,75.7442
Portugal,2091,90,30727,42491,73218,72.3141
Portugal,2091,91,26226,38305,64531,68.4663
Portugal,2091,92,21925,33501,55426,65.4458
Portugal,2091,93,18350,29861,48211,61.4514
Portugal,2091,94,15137,25498,40635,59.3654
Portugal,2091,95,11905,21465,33370,55.4624
Portugal,2091,96,9041,17612,26653,51.3343
Portugal,2091,97,6883,14605,21488,47.1277
Portugal,2091,98,4923,11264,16187,43.7056
Portugal,2091,99,3438,8351,11789,41.1687
Portugal,2091,100,5476,15738,21214,34.7948
Portugal,2092,0,27681,26035,53716,106.3223
Portugal,2092,1,27838,26189,54027,106.2965
Portugal,2092,2,28152,26488,54640,106.2821
Portugal,2092,3,28414,26741,55155,106.2563
Portugal,2092,4,28660,26981,55641,106.2229
Portugal,2092,5,28859,27172,56031,106.2086
Portugal,2092,6,29023,27330,56353,106.1947
Portugal,2092,7,29433,27714,57147,106.2026
Portugal,2092,8,29647,27917,57564,106.1969
Portugal,2092,9,29819,28079,57898,106.1968
Portugal,2092,10,30044,28292,58336,106.1926
Portugal,2092,11,30288,28525,58813,106.1805
Portugal,2092,12,30359,28593,58952,106.1763
Portugal,2092,13,30618,28840,59458,106.165
Portugal,2092,14,30794,29007,59801,106.1606
Portugal,2092,15,31097,29304,60401,106.1186
Portugal,2092,16,31584,29780,61364,106.0578
Portugal,2092,17,31754,29956,61710,106.0021
Portugal,2092,18,32011,30221,62232,105.923
Portugal,2092,19,32308,30527,62835,105.8342
Portugal,2092,20,32559,30790,63349,105.7454
Portugal,2092,21,32835,31075,63910,105.6637
Portugal,2092,22,33192,31436,64628,105.586
Portugal,2092,23,33503,31756,65259,105.5013
Portugal,2092,24,33795,32054,65849,105.4315
Portugal,2092,25,33969,32247,66216,105.34
Portugal,2092,26,34237,32518,66755,105.2863
Portugal,2092,27,34571,32855,67426,105.2229
Portugal,2092,28,34817,33105,67922,105.1714
Portugal,2092,29,35038,33328,68366,105.1308
Portugal,2092,30,35445,33726,69171,105.097
Portugal,2092,31,35597,33882,69479,105.0617
Portugal,2092,32,35776,34064,69840,105.0258
Portugal,2092,33,36141,34419,70560,105.0031
Portugal,2092,34,36406,34675,71081,104.9921
Portugal,2092,35,36726,34990,71716,104.9614
Portugal,2092,36,36995,35253,72248,104.9414
Portugal,2092,37,37284,35532,72816,104.9308
Portugal,2092,38,37661,35895,73556,104.9199
Portugal,2092,39,38014,36236,74250,104.9067
Portugal,2092,40,38401,36612,75013,104.8864
Portugal,2092,41,38779,36985,75764,104.8506
Portugal,2092,42,39333,37513,76846,104.8517
Portugal,2092,43,39734,37907,77641,104.8197
Portugal,2092,44,40050,38222,78272,104.7826
Portugal,2092,45,40489,38658,79147,104.7364
Portugal,2092,46,40747,38928,79675,104.6727
Portugal,2092,47,41125,39313,80438,104.6092
Portugal,2092,48,41569,39758,81327,104.5551
Portugal,2092,49,42082,40281,82363,104.4711
Portugal,2092,50,42391,40613,83004,104.3779
Portugal,2092,51,42647,40907,83554,104.2536
Portugal,2092,52,42961,41257,84218,104.1302
Portugal,2092,53,43159,41506,84665,103.9826
Portugal,2092,54,43167,41582,84749,103.8117
Portugal,2092,55,43410,41886,85296,103.6384
Portugal,2092,56,43586,42128,85714,103.4609
Portugal,2092,57,43600,42233,85833,103.2368
Portugal,2092,58,43538,42267,85805,103.0071
Portugal,2092,59,43240,42088,85328,102.7371
Portugal,2092,60,43227,42190,85417,102.4579
Portugal,2092,61,43005,42112,85117,102.1205
Portugal,2092,62,42788,42030,84818,101.8035
Portugal,2092,63,42657,42043,84700,101.4604
Portugal,2092,64,42454,41989,84443,101.1074
Portugal,2092,65,42330,42011,84341,100.7593
Portugal,2092,66,42151,41992,84143,100.3786
Portugal,2092,67,42200,42207,84407,99.9834
Portugal,2092,68,42213,42401,84614,99.5566
Portugal,2092,69,42220,42614,84834,99.0754
Portugal,2092,70,42276,42890,85166,98.5684
Portugal,2092,71,43955,44696,88651,98.3421
Portugal,2092,72,44824,45775,90599,97.9224
Portugal,2092,73,44289,46386,90675,95.4792
Portugal,2092,74,43864,45891,89755,95.583
Portugal,2092,75,44179,45988,90167,96.0664
Portugal,2092,76,42912,45403,88315,94.5136
Portugal,2092,77,41354,43334,84688,95.4308
Portugal,2092,78,40654,43624,84278,93.1918
Portugal,2092,79,43296,46096,89392,93.9257
Portugal,2092,80,44978,48567,93545,92.6102
Portugal,2092,81,45057,50409,95466,89.3828
Portugal,2092,82,42730,47952,90682,89.1099
Portugal,2092,83,43337,48784,92121,88.8345
Portugal,2092,84,41050,47331,88381,86.7296
Portugal,2092,85,40246,47717,87963,84.3431
Portugal,2092,86,39978,47734,87712,83.7516
Portugal,2092,87,36865,45771,82636,80.5423
Portugal,2092,88,35129,44768,79897,78.469
Portugal,2092,89,32407,42644,75051,75.9943
Portugal,2092,90,28957,39721,68678,72.901
Portugal,2092,91,27345,39413,66758,69.3807
Portugal,2092,92,22951,35055,58006,65.4714
Portugal,2092,93,18957,30387,49344,62.3852
Portugal,2092,94,15500,26602,42102,58.2663
Portugal,2092,95,12376,22111,34487,55.9721
Portugal,2092,96,9386,18023,27409,52.0779
Portugal,2092,97,6880,14303,21183,48.1018
Portugal,2092,98,5046,11446,16492,44.0853
Portugal,2092,99,3463,8485,11948,40.8132
Portugal,2092,100,5636,16106,21742,34.9932
Portugal,2093,0,27564,25928,53492,106.3098
Portugal,2093,1,27746,26102,53848,106.2984
Portugal,2093,2,27895,26246,54141,106.2829
Portugal,2093,3,28201,26537,54738,106.2705
Portugal,2093,4,28455,26782,55237,106.2467
Portugal,2093,5,28695,27016,55711,106.2148
Portugal,2093,6,28889,27202,56091,106.2017
Portugal,2093,7,29049,27355,56404,106.1927
Portugal,2093,8,29455,27736,57191,106.1977
Portugal,2093,9,29666,27936,57602,106.1927
Portugal,2093,10,29836,28096,57932,106.1931
Portugal,2093,11,30060,28310,58370,106.1816
Portugal,2093,12,30308,28547,58855,106.1688
Portugal,2093,13,30386,28623,59009,106.1594
Portugal,2093,14,30658,28884,59542,106.1418
Portugal,2093,15,30852,29072,59924,106.1227
Portugal,2093,16,31176,29393,60569,106.0661
Portugal,2093,17,31686,29895,61581,105.991
Portugal,2093,18,31879,30096,61975,105.9244
Portugal,2093,19,32157,30384,62541,105.8353
Portugal,2093,20,32472,30707,63179,105.7479
Portugal,2093,21,32736,30984,63720,105.6545
Portugal,2093,22,33022,31278,64300,105.5758
Portugal,2093,23,33383,31642,65025,105.5022
Portugal,2093,24,33695,31961,65656,105.4254
Portugal,2093,25,33985,32256,66241,105.3602
Portugal,2093,26,34154,32442,66596,105.2771
Portugal,2093,27,34415,32706,67121,105.2253
Portugal,2093,28,34740,33033,67773,105.1676
Portugal,2093,29,34978,33272,68250,105.1274
Portugal,2093,30,35188,33484,68672,105.089
Portugal,2093,31,35585,33871,69456,105.0604
Portugal,2093,32,35729,34016,69745,105.0359
Portugal,2093,33,35898,34188,70086,105.0018
Portugal,2093,34,36252,34533,70785,104.9778
Portugal,2093,35,36508,34779,71287,104.9714
Portugal,2093,36,36819,35085,71904,104.9423
Portugal,2093,37,37080,35340,72420,104.9236
Portugal,2093,38,37361,35611,72972,104.9142
Portugal,2093,39,37729,35966,73695,104.9019
Portugal,2093,40,38074,36300,74374,104.8871
Portugal,2093,41,38452,36669,75121,104.8624
Portugal,2093,42,38822,37035,75857,104.8252
Portugal,2093,43,39369,37558,76927,104.8219
Portugal,2093,44,39761,37947,77708,104.7804
Portugal,2093,45,40070,38257,78327,104.739
Portugal,2093,46,40500,38688,79188,104.6836
Portugal,2093,47,40750,38953,79703,104.6133
Portugal,2093,48,41119,39333,80452,104.5407
Portugal,2093,49,41555,39774,81329,104.4778
Portugal,2093,50,42059,40293,82352,104.3829
Portugal,2093,51,42357,40620,82977,104.2762
Portugal,2093,52,42603,40910,83513,104.1384
Portugal,2093,53,42907,41257,84164,103.9993
Portugal,2093,54,43097,41503,84600,103.8407
Portugal,2093,55,43098,41575,84673,103.6633
Portugal,2093,56,43332,41876,85208,103.4769
Portugal,2093,57,43497,42115,85612,103.2815
Portugal,2093,58,43501,42217,85718,103.0414
Portugal,2093,59,43428,42247,85675,102.7955
Portugal,2093,60,43119,42064,85183,102.5081
Portugal,2093,61,43093,42162,85255,102.2081
Portugal,2093,62,42869,42083,84952,101.8677
Portugal,2093,63,42656,42003,84659,101.5547
Portugal,2093,64,42524,42014,84538,101.2139
Portugal,2093,65,42320,41959,84279,100.8604
Portugal,2093,66,42193,41979,84172,100.5098
Portugal,2093,67,42008,41958,83966,100.1192
Portugal,2093,68,42047,42170,84217,99.7083
Portugal,2093,69,42042,42357,84399,99.2563
Portugal,2093,70,42041,42566,84607,98.7666
Portugal,2093,71,42083,42836,84919,98.2421
Portugal,2093,72,43736,44633,88369,97.9903
Portugal,2093,73,44590,45706,90296,97.5583
Portugal,2093,74,44034,46306,90340,95.0935
Portugal,2093,75,43590,45804,89394,95.1664
Portugal,2093,76,43872,45887,89759,95.6088
Portugal,2093,77,42568,45283,87851,94.0044
Portugal,2093,78,40978,43199,84177,94.8587
Portugal,2093,79,40217,43453,83670,92.5529
Portugal,2093,80,42732,45864,88596,93.1711
Portugal,2093,81,44230,48234,92464,91.6988
Portugal,2093,82,44147,49973,94120,88.3417
Portugal,2093,83,41724,47454,89178,87.9251
Portugal,2093,84,42121,48155,90276,87.4696
Portugal,2093,85,39660,46554,86214,85.1914
Portugal,2093,86,38541,46666,85207,82.589
Portugal,2093,87,37899,46361,84260,81.7476
Portugal,2093,88,34580,44148,78728,78.3274
Portugal,2093,89,32408,42704,75112,75.8898
Portugal,2093,90,29391,40193,69584,73.1247
Portugal,2093,91,25794,36891,62685,69.9195
Portugal,2093,92,23955,36120,60075,66.3206
Portugal,2093,93,19866,31845,51711,62.3834
Portugal,2093,94,16032,27115,43147,59.1259
Portugal,2093,95,12688,23108,35796,54.9074
Portugal,2093,96,9769,18600,28369,52.5215
Portugal,2093,97,7150,14663,21813,48.7622
Portugal,2093,98,5049,11229,16278,44.9639
Portugal,2093,99,3553,8637,12190,41.137
Portugal,2093,100,5757,16470,22227,34.9545
Portugal,2094,0,27543,25910,53453,106.3026
Portugal,2094,1,27629,25995,53624,106.2858
Portugal,2094,2,27803,26159,53962,106.2846
Portugal,2094,3,27943,26295,54238,106.2674
Portugal,2094,4,28242,26578,54820,106.2608
Portugal,2094,5,28490,26818,55308,106.2346
Portugal,2094,6,28725,27046,55771,106.2079
Portugal,2094,7,28915,27227,56142,106.1997
Portugal,2094,8,29071,27377,56448,106.1877
Portugal,2094,9,29474,27755,57229,106.1935
Portugal,2094,10,29683,27953,57636,106.189
Portugal,2094,11,29852,28113,57965,106.1858
Portugal,2094,12,30080,28331,58411,106.1734
Portugal,2094,13,30335,28577,58912,106.1518
Portugal,2094,14,30426,28667,59093,106.136
Portugal,2094,15,30715,28949,59664,106.1004
Portugal,2094,16,30930,29161,60091,106.0663
Portugal,2094,17,31278,29508,60786,105.9984
Portugal,2094,18,31811,30035,61846,105.9131
Portugal,2094,19,32026,30258,62284,105.8431
Portugal,2094,20,32321,30564,62885,105.7486
Portugal,2094,21,32649,30901,63550,105.6568
Portugal,2094,22,32923,31187,64110,105.5664
Portugal,2094,23,33213,31484,64697,105.4917
Portugal,2094,24,33575,31847,65422,105.4259
Portugal,2094,25,33884,32163,66047,105.3509
Portugal,2094,26,34170,32452,66622,105.294
Portugal,2094,27,34332,32630,66962,105.2161
Portugal,2094,28,34585,32883,67468,105.1759
Portugal,2094,29,34900,33200,68100,105.1205
Portugal,2094,30,35128,33428,68556,105.0856
Portugal,2094,31,35329,33629,68958,105.0552
Portugal,2094,32,35717,34006,69723,105.0315
Portugal,2094,33,35850,34140,69990,105.0088
Portugal,2094,34,36009,34302,70311,104.9764
Portugal,2094,35,36354,34637,70991,104.9571
Portugal,2094,36,36601,34874,71475,104.9521
Portugal,2094,37,36904,35172,72076,104.9244
Portugal,2094,38,37156,35419,72575,104.9041
Portugal,2094,39,37429,35682,73111,104.896
Portugal,2094,40,37789,36030,73819,104.882
Portugal,2094,41,38125,36357,74482,104.8629
Portugal,2094,42,38496,36720,75216,104.8366
Portugal,2094,43,38858,37081,75939,104.7922
Portugal,2094,44,39397,37598,76995,104.7848
Portugal,2094,45,39782,37983,77765,104.7363
Portugal,2094,46,40083,38287,78370,104.6909
Portugal,2094,47,40504,38713,79217,104.6264
Portugal,2094,48,40746,38974,79720,104.5466
Portugal,2094,49,41107,39350,80457,104.4651
Portugal,2094,50,41534,39786,81320,104.3935
Portugal,2094,51,42027,40301,82328,104.2828
Portugal,2094,52,42315,40624,82939,104.1626
Portugal,2094,53,42552,40910,83462,104.0137
Portugal,2094,54,42848,41254,84102,103.8639
Portugal,2094,55,43030,41497,84527,103.6942
Portugal,2094,56,43022,41566,84588,103.5029
Portugal,2094,57,43246,41864,85110,103.3012
Portugal,2094,58,43401,42100,85501,103.0903
Portugal,2094,59,43394,42198,85592,102.8343
Portugal,2094,60,43309,42224,85533,102.5696
Portugal,2094,61,42989,42036,85025,102.2671
Portugal,2094,62,42960,42134,85094,101.9604
Portugal,2094,63,42740,42057,84797,101.624
Portugal,2094,64,42526,41975,84501,101.3127
Portugal,2094,65,42393,41985,84378,100.9718
Portugal,2094,66,42188,41928,84116,100.6201
Portugal,2094,67,42054,41947,84001,100.2551
Portugal,2094,68,41860,41923,83783,99.8497
Portugal,2094,69,41882,42127,84009,99.4184
Portugal,2094,70,41869,42311,84180,98.9554
Portugal,2094,71,41855,42514,84369,98.4499
Portugal,2094,72,41881,42779,84660,97.9008
Portugal,2094,73,43514,44568,88082,97.6351
Portugal,2094,74,44340,45630,89970,97.1729
Portugal,2094,75,43767,46222,89989,94.6887
Portugal,2094,76,43297,45708,89005,94.7252
Portugal,2094,77,43531,45771,89302,95.1061
Portugal,2094,78,42193,45148,87341,93.4549
Portugal,2094,79,40551,43037,83588,94.2236
Portugal,2094,80,39707,43243,82950,91.823
Portugal,2094,81,42038,45559,87597,92.2716
Portugal,2094,82,43358,47829,91187,90.6521
Portugal,2094,83,43132,49470,92602,87.1882
Portugal,2094,84,40579,46861,87440,86.5944
Portugal,2094,85,40724,47387,88111,85.9392
Portugal,2094,86,38011,45554,83565,83.4416
Portugal,2094,87,36570,45354,81924,80.6324
Portugal,2094,88,35587,44752,80339,79.5205
Portugal,2094,89,31939,42150,74089,75.7746
Portugal,2094,90,29429,40290,69719,73.0429
Portugal,2094,91,26215,37371,63586,70.148
Portugal,2094,92,22629,33850,56479,66.8508
Portugal,2094,93,20767,32857,53624,63.2042
Portugal,2094,94,16828,28458,45286,59.1328
Portugal,2094,95,13146,23591,36737,55.7246
Portugal,2094,96,10032,19470,29502,51.5254
Portugal,2094,97,7455,15158,22613,49.182
Portugal,2094,98,5256,11532,16788,45.5775
Portugal,2094,99,3561,8488,12049,41.9533
Portugal,2094,100,5896,16836,22732,35.0202
Portugal,2095,0,27347,25728,53075,106.2928
Portugal,2095,1,27608,25976,53584,106.2827
Portugal,2095,2,27686,26052,53738,106.2721
Portugal,2095,3,27851,26208,54059,106.2691
Portugal,2095,4,27985,26336,54321,106.2614
Portugal,2095,5,28277,26613,54890,106.2526
Portugal,2095,6,28520,26848,55368,106.2277
Portugal,2095,7,28751,27072,55823,106.202
Portugal,2095,8,28937,27249,56186,106.1947
Portugal,2095,9,29090,27396,56486,106.1834
Portugal,2095,10,29490,27772,57262,106.1861
Portugal,2095,11,29699,27970,57669,106.1816
Portugal,2095,12,29872,28135,58007,106.1738
Portugal,2095,13,30108,28361,58469,106.1599
Portugal,2095,14,30375,28622,58997,106.1247
Portugal,2095,15,30484,28732,59216,106.0977
Portugal,2095,16,30794,29038,59832,106.0472
Portugal,2095,17,31033,29275,60308,106.0051
Portugal,2095,18,31404,29648,61052,105.9228
Portugal,2095,19,31958,30197,62155,105.8317
Portugal,2095,20,32189,30439,62628,105.7492
Portugal,2095,21,32498,30758,63256,105.6571
Portugal,2095,22,32836,31104,63940,105.5684
Portugal,2095,23,33114,31393,64507,105.4821
Portugal,2095,24,33405,31689,65094,105.4151
Portugal,2095,25,33765,32049,65814,105.3543
Portugal,2095,26,34069,32359,66428,105.2845
Portugal,2095,27,34348,32639,66987,105.2361
Portugal,2095,28,34501,32807,67308,105.1635
Portugal,2095,29,34745,33050,67795,105.1286
Portugal,2095,30,35051,33356,68407,105.0815
Portugal,2095,31,35269,33573,68842,105.0517
Portugal,2095,32,35461,33764,69225,105.0261
Portugal,2095,33,35839,34130,69969,105.0073
Portugal,2095,34,35962,34254,70216,104.9863
Portugal,2095,35,36111,34406,70517,104.9555
Portugal,2095,36,36447,34732,71179,104.9378
Portugal,2095,37,36687,34961,71648,104.9369
Portugal,2095,38,36981,35251,72232,104.9077
Portugal,2095,39,37225,35490,72715,104.8887
Portugal,2095,40,37489,35747,73236,104.8731
Portugal,2095,41,37841,36087,73928,104.8605
Portugal,2095,42,38169,36408,74577,104.8368
Portugal,2095,43,38532,36766,75298,104.8034
Portugal,2095,44,38887,37122,76009,104.7546
Portugal,2095,45,39418,37634,77052,104.7404
Portugal,2095,46,39795,38013,77808,104.6879
Portugal,2095,47,40088,38313,78401,104.6329
Portugal,2095,48,40501,38734,79235,104.5619
Portugal,2095,49,40734,38990,79724,104.4729
Portugal,2095,50,41087,39363,80450,104.3797
Portugal,2095,51,41503,39795,81298,104.292
Portugal,2095,52,41986,40306,82292,104.1681
Portugal,2095,53,42266,40625,82891,104.0394
Portugal,2095,54,42494,40908,83402,103.877
Portugal,2095,55,42782,41249,84031,103.7165
Portugal,2095,56,42955,41489,84444,103.5335
Portugal,2095,57,42938,41555,84493,103.3281
Portugal,2095,58,43152,41850,85002,103.1111
Portugal,2095,59,43296,42082,85378,102.8848
Portugal,2095,60,43278,42176,85454,102.6129
Portugal,2095,61,43180,42198,85378,102.3271
Portugal,2095,62,42858,42010,84868,102.0186
Portugal,2095,63,42833,42109,84942,101.7193
Portugal,2095,64,42613,42031,84644,101.3847
Portugal,2095,65,42399,41948,84347,101.0751
Portugal,2095,66,42263,41956,84219,100.7317
Portugal,2095,67,42051,41898,83949,100.3652
Portugal,2095,68,41909,41913,83822,99.9905
Portugal,2095,69,41699,41883,83582,99.5607
Portugal,2095,70,41713,42084,83797,99.1184
Portugal,2095,71,41688,42263,83951,98.6395
Portugal,2095,72,41658,42460,84118,98.1112
Portugal,2095,73,41673,42720,84393,97.5492
Portugal,2095,74,43276,44498,87774,97.2538
Portugal,2095,75,44078,45551,89629,96.7663
Portugal,2095,76,43479,46129,89608,94.2552
Portugal,2095,77,42967,45597,88564,94.2321
Portugal,2095,78,43154,45639,88793,94.5551
Portugal,2095,79,41761,44985,86746,92.8332
Portugal,2095,80,40046,42837,82883,93.4846
Portugal,2095,81,39074,42966,82040,90.9417
Portugal,2095,82,41224,45191,86415,91.2217
Portugal,2095,83,42377,47364,89741,89.4709
Portugal,2095,84,41966,48871,90837,85.871
Portugal,2095,85,39252,46135,85387,85.0807
Portugal,2095,86,39053,46397,85450,84.1714
Portugal,2095,87,36091,44305,80396,81.4603
Portugal,2095,88,34365,43817,78182,78.4285
Portugal,2095,89,32895,42767,75662,76.9168
Portugal,2095,90,29028,39811,68839,72.9145
Portugal,2095,91,26274,37507,63781,70.0509
Portugal,2095,92,23021,34337,57358,67.0443
Portugal,2095,93,19638,30838,50476,63.6812
Portugal,2095,94,17611,29409,47020,59.883
Portugal,2095,95,13815,24802,38617,55.7012
Portugal,2095,96,10406,19912,30318,52.2599
Portugal,2095,97,7665,15897,23562,48.2166
Portugal,2095,98,5486,11943,17429,45.9349
Portugal,2095,99,3711,8732,12443,42.4989
Portugal,2095,100,5991,16988,22979,35.2661
Portugal,2096,0,27323,25711,53034,106.2697
Portugal,2096,1,27412,25795,53207,106.2687
Portugal,2096,2,27665,26034,53699,106.2649
Portugal,2096,3,27735,26101,53836,106.2603
Portugal,2096,4,27893,26250,54143,106.259
Portugal,2096,5,28020,26371,54391,106.2531
Portugal,2096,6,28307,26643,54950,106.2455
Portugal,2096,7,28546,26873,55419,106.2256
Portugal,2096,8,28773,27094,55867,106.1969
Portugal,2096,9,28955,27268,56223,106.1867
Portugal,2096,10,29106,27413,56519,106.1759
Portugal,2096,11,29507,27789,57296,106.1823
Portugal,2096,12,29719,27991,57710,106.1734
Portugal,2096,13,29899,28165,58064,106.1566
Portugal,2096,14,30147,28406,58553,106.129
Portugal,2096,15,30433,28687,59120,106.0864
Portugal,2096,16,30563,28821,59384,106.0442
Portugal,2096,17,30897,29153,60050,105.9822
Portugal,2096,18,31158,29415,60573,105.9255
Portugal,2096,19,31550,29810,61360,105.837
Portugal,2096,20,32122,30378,62500,105.741
Portugal,2096,21,32367,30633,63000,105.6606
Portugal,2096,22,32685,30961,63646,105.5683
Portugal,2096,23,33027,31310,64337,105.4839
Portugal,2096,24,33306,31598,64904,105.4054
Portugal,2096,25,33595,31891,65486,105.3432
Portugal,2096,26,33950,32245,66195,105.2876
Portugal,2096,27,34248,32547,66795,105.2263
Portugal,2096,28,34517,32817,67334,105.1802
Portugal,2096,29,34662,32974,67636,105.1192
Portugal,2096,30,34896,33206,68102,105.0894
Portugal,2096,31,35192,33501,68693,105.0476
Portugal,2096,32,35401,33708,69109,105.0225
Portugal,2096,33,35583,33888,69471,105.0018
Portugal,2096,34,35950,34244,70194,104.9819
Portugal,2096,35,36064,34358,70422,104.9654
Portugal,2096,36,36205,34502,70707,104.9359
Portugal,2096,37,36533,34819,71352,104.9226
Portugal,2096,38,36764,35040,71804,104.9201
Portugal,2096,39,37050,35322,72372,104.8921
Portugal,2096,40,37285,35554,72839,104.8687
Portugal,2096,41,37541,35804,73345,104.8514
Portugal,2096,42,37885,36139,74024,104.8313
Portugal,2096,43,38206,36454,74660,104.8061
Portugal,2096,44,38562,36807,75369,104.7681
Portugal,2096,45,38909,37157,76066,104.7151
Portugal,2096,46,39432,37665,77097,104.6914
Portugal,2096,47,39801,38039,77840,104.6321
Portugal,2096,48,40085,38335,78420,104.565
Portugal,2096,49,40490,38751,79241,104.4876
Portugal,2096,50,40716,39004,79720,104.3893
Portugal,2096,51,41059,39372,80431,104.2848
Portugal,2096,52,41465,39801,81266,104.1808
Portugal,2096,53,41939,40308,82247,104.0463
Portugal,2096,54,42210,40624,82834,103.9041
Portugal,2096,55,42431,40905,83336,103.7306
Portugal,2096,56,42710,41242,83952,103.5595
Portugal,2096,57,42873,41478,84351,103.3632
Portugal,2096,58,42847,41542,84389,103.1414
Portugal,2096,59,43050,41833,84883,102.9092
Portugal,2096,60,43182,42061,85243,102.6652
Portugal,2096,61,43151,42151,85302,102.3724
Portugal,2096,62,43052,42173,85225,102.0843
Portugal,2096,63,42735,41986,84721,101.7839
Portugal,2096,64,42708,42084,84792,101.4827
Portugal,2096,65,42488,42005,84493,101.1499
Portugal,2096,66,42272,41920,84192,100.8397
Portugal,2096,67,42130,41927,84057,100.4842
Portugal,2096,68,41910,41865,83775,100.1075
Portugal,2096,69,41752,41875,83627,99.7063
Portugal,2096,70,41536,41842,83378,99.2687
Portugal,2096,71,41537,42038,83575,98.8082
Portugal,2096,72,41496,42211,83707,98.3061
Portugal,2096,73,41457,42404,83861,97.7667
Portugal,2096,74,41451,42656,84107,97.1751
Portugal,2096,75,43027,44425,87452,96.8531
Portugal,2096,76,43795,45464,89259,96.329
Portugal,2096,77,43156,46022,89178,93.7725
Portugal,2096,78,42605,45472,88077,93.695
Portugal,2096,79,42724,45482,88206,93.9361
Portugal,2096,80,41254,44784,86038,92.1177
Portugal,2096,81,39421,42572,81993,92.5984
Portugal,2096,82,38332,42630,80962,89.9179
Portugal,2096,83,40309,44765,85074,90.0458
Portugal,2096,84,41253,46809,88062,88.1305
Portugal,2096,85,40618,48137,88755,84.38
Portugal,2096,86,37667,45198,82865,83.3378
Portugal,2096,87,37109,45156,82265,82.1796
Portugal,2096,88,33943,42838,76781,79.2357
Portugal,2096,89,31796,41914,73710,75.8601
Portugal,2096,90,29929,40438,70367,74.0121
Portugal,2096,91,25946,37106,63052,69.924
Portugal,2096,92,23100,34508,57608,66.941
Portugal,2096,93,20005,31328,51333,63.8566
Portugal,2096,94,16677,27645,44322,60.3256
Portugal,2096,95,14478,25674,40152,56.3917
Portugal,2096,96,10951,20971,31922,52.2197
Portugal,2096,97,7962,16287,24249,48.8856
Portugal,2096,98,5649,12548,18197,45.0191
Portugal,2096,99,3879,9060,12939,42.8146
Portugal,2096,100,6154,17275,23429,35.6237
Portugal,2097,0,27274,25659,52933,106.2941
Portugal,2097,1,27388,25778,53166,106.2456
Portugal,2097,2,27469,25852,53321,106.2548
Portugal,2097,3,27714,26083,53797,106.2531
Portugal,2097,4,27776,26142,53918,106.2505
Portugal,2097,5,27928,26285,54213,106.2507
Portugal,2097,6,28050,26401,54451,106.246
Portugal,2097,7,28333,26669,55002,106.2395
Portugal,2097,8,28568,26895,55463,106.2205
Portugal,2097,9,28792,27113,55905,106.1926
Portugal,2097,10,28972,27285,56257,106.1829
Portugal,2097,11,29123,27430,56553,106.1721
Portugal,2097,12,29527,27810,57337,106.174
Portugal,2097,13,29746,28022,57768,106.1523
Portugal,2097,14,29939,28210,58149,106.129
Portugal,2097,15,30205,28471,58676,106.0904
Portugal,2097,16,30512,28775,59287,106.0365
Portugal,2097,17,30665,28936,59601,105.9753
Portugal,2097,18,31022,29293,60315,105.9024
Portugal,2097,19,31305,29578,60883,105.8388
Portugal,2097,20,31714,29991,61705,105.7451
Portugal,2097,21,32299,30572,62871,105.649
Portugal,2097,22,32554,30836,63390,105.5714
Portugal,2097,23,32876,31167,64043,105.4834
Portugal,2097,24,33220,31516,64736,105.4068
Portugal,2097,25,33497,31801,65298,105.3332
Portugal,2097,26,33780,32087,65867,105.2763
Portugal,2097,27,34128,32433,66561,105.2262
Portugal,2097,28,34417,32724,67141,105.1736
Portugal,2097,29,34678,32984,67662,105.1358
Portugal,2097,30,34813,33130,67943,105.08
Portugal,2097,31,35037,33352,68389,105.0522
Portugal,2097,32,35324,33635,68959,105.0216
Portugal,2097,33,35523,33832,69355,104.9982
Portugal,2097,34,35694,34002,69696,104.9762
Portugal,2097,35,36053,34348,70401,104.9639
Portugal,2097,36,36158,34454,70612,104.9457
Portugal,2097,37,36291,34589,70880,104.9206
Portugal,2097,38,36610,34899,71509,104.9027
Portugal,2097,39,36833,35112,71945,104.9015
Portugal,2097,40,37111,35387,72498,104.8718
Portugal,2097,41,37338,35612,72950,104.8467
Portugal,2097,42,37586,35856,73442,104.8249
Portugal,2097,43,37923,36185,74108,104.8031
Portugal,2097,44,38236,36495,74731,104.7705
Portugal,2097,45,38585,36843,75428,104.7282
Portugal,2097,46,38924,37189,76113,104.6654
Portugal,2097,47,39439,37691,77130,104.6377
Portugal,2097,48,39800,38061,77861,104.569
Portugal,2097,49,40077,38353,78430,104.4951
Portugal,2097,50,40473,38765,79238,104.406
Portugal,2097,51,40689,39014,79703,104.2933
Portugal,2097,52,41022,39379,80401,104.1723
Portugal,2097,53,41419,39803,81222,104.06
Portugal,2097,54,41885,40307,82192,103.915
Portugal,2097,55,42149,40621,82770,103.7616
Portugal,2097,56,42361,40898,83259,103.5772
Portugal,2097,57,42631,41232,83863,103.393
Portugal,2097,58,42785,41466,84251,103.1809
Portugal,2097,59,42748,41527,84275,102.9403
Portugal,2097,60,42939,41813,84752,102.6929
Portugal,2097,61,43058,42037,85095,102.4288
Portugal,2097,62,43026,42126,85152,102.1364
Portugal,2097,63,42931,42150,85081,101.8529
Portugal,2097,64,42613,41962,84575,101.5514
Portugal,2097,65,42586,42059,84645,101.253
Portugal,2097,66,42364,41978,84342,100.9195
Portugal,2097,67,42142,41892,84034,100.5968
Portugal,2097,68,41992,41896,83888,100.2291
Portugal,2097,69,41757,41829,83586,99.8279
Portugal,2097,70,41592,41835,83427,99.4191
Portugal,2097,71,41365,41798,83163,98.9641
Portugal,2097,72,41351,41988,83339,98.4829
Portugal,2097,73,41301,42158,83459,97.9672
Portugal,2097,74,41242,42343,83585,97.3998
Portugal,2097,75,41219,42588,83807,96.7855
Portugal,2097,76,42758,44343,87101,96.4256
Portugal,2097,77,43478,45363,88841,95.8446
Portugal,2097,78,42802,45901,88703,93.2485
Portugal,2097,79,42191,45321,87512,93.0937
Portugal,2097,80,42217,45286,87503,93.2231
Portugal,2097,81,40623,44517,85140,91.2528
Portugal,2097,82,38688,42250,80938,91.5692
Portugal,2097,83,37498,42241,79739,88.7716
Portugal,2097,84,39259,44256,83515,88.7089
Portugal,2097,85,39951,46125,86076,86.6146
Portugal,2097,86,39004,47183,86187,82.6654
Portugal,2097,87,35819,44017,79836,81.3754
Portugal,2097,88,34930,43693,78623,79.9442
Portugal,2097,89,31436,41012,72448,76.6507
Portugal,2097,90,28960,39670,68630,73.0023
Portugal,2097,91,26781,37731,64512,70.9788
Portugal,2097,92,22838,34180,57018,66.8169
Portugal,2097,93,20099,31525,51624,63.7557
Portugal,2097,94,17011,28124,45135,60.4857
Portugal,2097,95,13730,24171,37901,56.8036
Portugal,2097,96,11494,21743,33237,52.863
Portugal,2097,97,8391,17181,25572,48.8388
Portugal,2097,98,5876,12878,18754,45.6282
Portugal,2097,99,3999,9534,13533,41.9446
Portugal,2097,100,6374,17716,24090,35.9788
Portugal,2098,0,27122,25517,52639,106.2899
Portugal,2098,1,27339,25726,53065,106.2699
Portugal,2098,2,27445,25835,53280,106.2319
Portugal,2098,3,27518,25901,53419,106.243
Portugal,2098,4,27755,26124,53879,106.2433
Portugal,2098,5,27811,26178,53989,106.2381
Portugal,2098,6,27958,26315,54273,106.2436
Portugal,2098,7,28075,26427,54502,106.236
Portugal,2098,8,28355,26691,55046,106.2343
Portugal,2098,9,28587,26914,55501,106.2161
Portugal,2098,10,28809,27130,55939,106.1887
Portugal,2098,11,28989,27302,56291,106.179
Portugal,2098,12,29143,27452,56595,106.1598
Portugal,2098,13,29554,27841,57395,106.1528
Portugal,2098,14,29786,28066,57852,106.1284
Portugal,2098,15,29997,28275,58272,106.0902
Portugal,2098,16,30284,28560,58844,106.0364
Portugal,2098,17,30614,28890,59504,105.9675
Portugal,2098,18,30791,29076,59867,105.8983
Portugal,2098,19,31169,29455,60624,105.819
Portugal,2098,20,31469,29759,61228,105.7462
Portugal,2098,21,31892,30185,62077,105.6551
Portugal,2098,22,32486,30775,63261,105.5597
Portugal,2098,23,32745,31042,63787,105.4861
Portugal,2098,24,33069,31373,64442,105.4059
Portugal,2098,25,33410,31718,65128,105.3345
Portugal,2098,26,33682,31996,65678,105.2694
Portugal,2098,27,33959,32275,66234,105.2177
Portugal,2098,28,34298,32610,66908,105.1763
Portugal,2098,29,34578,32891,67469,105.1291
Portugal,2098,30,34829,33140,67969,105.0966
Portugal,2098,31,34954,33276,68230,105.0427
Portugal,2098,32,35169,33486,68655,105.026
Portugal,2098,33,35446,33759,69205,104.9972
Portugal,2098,34,35635,33946,69581,104.9755
Portugal,2098,35,35797,34106,69903,104.9581
Portugal,2098,36,36147,34444,70591,104.9443
Portugal,2098,37,36244,34541,70785,104.9304
Portugal,2098,38,36368,34668,71036,104.9037
Portugal,2098,39,36680,34970,71650,104.8899
Portugal,2098,40,36894,35177,72071,104.881
Portugal,2098,41,37163,35445,72608,104.8469
Portugal,2098,42,37383,35664,73047,104.82
Portugal,2098,43,37624,35903,73527,104.7935
Portugal,2098,44,37954,36227,74181,104.7672
Portugal,2098,45,38260,36532,74792,104.7301
Portugal,2098,46,38601,36875,75476,104.6807
Portugal,2098,47,38932,37216,76148,104.6109
Portugal,2098,48,39439,37714,77153,104.5739
Portugal,2098,49,39792,38080,77872,104.4958
Portugal,2098,50,40061,38367,78428,104.4153
Portugal,2098,51,40448,38776,79224,104.3119
Portugal,2098,52,40654,39021,79675,104.1849
Portugal,2098,53,40979,39382,80361,104.0552
Portugal,2098,54,41368,39804,81172,103.9293
Portugal,2098,55,41826,40305,82131,103.7737
Portugal,2098,56,42082,40616,82698,103.6094
Portugal,2098,57,42285,40890,83175,103.4116
Portugal,2098,58,42544,41221,83765,103.2095
Portugal,2098,59,42688,41452,84140,102.9818
Portugal,2098,60,42640,41508,84148,102.7272
Portugal,2098,61,42819,41791,84610,102.4599
Portugal,2098,62,42936,42014,84950,102.1945
Portugal,2098,63,42908,42105,85013,101.9071
Portugal,2098,64,42811,42127,84938,101.6237
Portugal,2098,65,42494,41939,84433,101.3234
Portugal,2098,66,42465,42034,84499,101.0254
Portugal,2098,67,42237,41952,84189,100.6793
Portugal,2098,68,42007,41863,83870,100.344
Portugal,2098,69,41842,41861,83703,99.9546
Portugal,2098,70,41601,41791,83392,99.5454
Portugal,2098,71,41426,41794,83220,99.1195
Portugal,2098,72,41184,41751,82935,98.6419
Portugal,2098,73,41162,41939,83101,98.1473
Portugal,2098,74,41092,42101,83193,97.6034
Portugal,2098,75,41017,42280,83297,97.0128
Portugal,2098,76,40968,42514,83482,96.3636
Portugal,2098,77,42457,44250,86707,95.948
Portugal,2098,78,43130,45249,88379,95.317
Portugal,2098,79,42396,45756,88152,92.6567
Portugal,2098,80,41701,45135,86836,92.3917
Portugal,2098,81,41585,45026,86611,92.3577
Portugal,2098,82,39882,44193,84075,90.2451
Portugal,2098,83,37862,41879,79741,90.4081
Portugal,2098,84,36541,41778,78319,87.4647
Portugal,2098,85,38042,43632,81674,87.1883
Portugal,2098,86,38389,45239,83628,84.8582
Portugal,2098,87,37117,45984,83101,80.7172
Portugal,2098,88,33745,42627,76372,79.1634
Portugal,2098,89,32380,41873,74253,77.3291
Portugal,2098,90,28662,38862,67524,73.7533
Portugal,2098,91,25942,37062,63004,69.9962
Portugal,2098,92,23602,34806,58408,67.8101
Portugal,2098,93,19897,31275,51172,63.6195
Portugal,2098,94,17115,28350,45465,60.3704
Portugal,2098,95,14025,24634,38659,56.9335
Portugal,2098,96,10915,20510,31425,53.2179
Portugal,2098,97,8819,17849,26668,49.4089
Portugal,2098,98,6201,13612,19813,45.5554
Portugal,2098,99,4165,9804,13969,42.4827
Portugal,2098,100,6600,18384,24984,35.9008
Portugal,2099,0,27013,25411,52424,106.3044
Portugal,2099,1,27188,25584,52772,106.2695
Portugal,2099,2,27396,25783,53179,106.2561
Portugal,2099,3,27494,25884,53378,106.2201
Portugal,2099,4,27559,25943,53502,106.229
Portugal,2099,5,27790,26159,53949,106.2349
Portugal,2099,6,27841,26208,54049,106.2309
Portugal,2099,7,27983,26341,54324,106.2336
Portugal,2099,8,28097,26449,54546,106.2309
Portugal,2099,9,28374,26710,55084,106.2299
Portugal,2099,10,28603,26931,55534,106.2085
Portugal,2099,11,28825,27147,55972,106.1812
Portugal,2099,12,29009,27324,56333,106.1667
Portugal,2099,13,29170,27482,56652,106.1422
Portugal,2099,14,29594,27885,57479,106.1287
Portugal,2099,15,29844,28131,57975,106.0894
Portugal,2099,16,30076,28364,58440,106.0358
Portugal,2099,17,30386,28675,59061,105.9669
Portugal,2099,18,30740,29030,59770,105.8905
Portugal,2099,19,30938,29239,60177,105.8107
Portugal,2099,20,31333,29636,60969,105.7261
Portugal,2099,21,31647,29953,61600,105.6555
Portugal,2099,22,32079,30388,62467,105.5647
Portugal,2099,23,32678,30981,63659,105.4776
Portugal,2099,24,32938,31248,64186,105.4083
Portugal,2099,25,33259,31575,64834,105.3333
Portugal,2099,26,33595,31914,65509,105.2673
Portugal,2099,27,33860,32184,66044,105.2076
Portugal,2099,28,34129,32452,66581,105.1676
Portugal,2099,29,34459,32777,67236,105.1316
Portugal,2099,30,34729,33048,67777,105.0865
Portugal,2099,31,34970,33285,68255,105.0623
Portugal,2099,32,35086,33410,68496,105.0165
Portugal,2099,33,35291,33610,68901,105.0015
Portugal,2099,34,35558,33874,69432,104.9714
Portugal,2099,35,35737,34050,69787,104.9545
Portugal,2099,36,35891,34202,70093,104.9383
Portugal,2099,37,36233,34531,70764,104.9289
Portugal,2099,38,36322,34621,70943,104.9132
Portugal,2099,39,36438,34740,71178,104.8877
Portugal,2099,40,36741,35035,71776,104.8694
Portugal,2099,41,36947,35235,72182,104.8588
Portugal,2099,42,37209,35497,72706,104.8229
Portugal,2099,43,37422,35711,73133,104.7912
Portugal,2099,44,37656,35944,73600,104.763
Portugal,2099,45,37978,36263,74241,104.7293
Portugal,2099,46,38277,36564,74841,104.6849
Portugal,2099,47,38609,36902,75511,104.6258
Portugal,2099,48,38933,37239,76172,104.549
Portugal,2099,49,39432,37732,77164,104.5055
Portugal,2099,50,39777,38095,77872,104.4153
Portugal,2099,51,40037,38379,78416,104.3201
Portugal,2099,52,40414,38784,79198,104.2028
Portugal,2099,53,40613,39026,79639,104.0665
Portugal,2099,54,40930,39384,80314,103.9255
Portugal,2099,55,41312,39802,81114,103.7938
Portugal,2099,56,41761,40301,82062,103.6227
Portugal,2099,57,42007,40608,82615,103.4451
Portugal,2099,58,42201,40879,83080,103.2339
Portugal,2099,59,42450,41208,83658,103.014
Portugal,2099,60,42582,41434,84016,102.7707
Portugal,2099,61,42523,41487,84010,102.4972
Portugal,2099,62,42699,41769,84468,102.2265
Portugal,2099,63,42820,41994,84814,101.9669
Portugal,2099,64,42791,42083,84874,101.6824
Portugal,2099,65,42695,42105,84800,101.4013
Portugal,2099,66,42376,41915,84291,101.0998
Portugal,2099,67,42341,42009,84350,100.7903
Portugal,2099,68,42106,41924,84030,100.4341
Portugal,2099,69,41861,41830,83691,100.0741
Portugal,2099,70,41690,41826,83516,99.6748
Portugal,2099,71,41439,41752,83191,99.2503
Portugal,2099,72,41250,41750,83000,98.8024
Portugal,2099,73,41001,41704,82705,98.3143
Portugal,2099,74,40960,41885,82845,97.7916
Portugal,2099,75,40875,42041,82916,97.2265
Portugal,2099,76,40774,42210,82984,96.598
Portugal,2099,77,40688,42429,83117,95.8967
Portugal,2099,78,42126,44145,86271,95.4264
Portugal,2099,79,42731,45113,87844,94.7199
Portugal,2099,80,41916,45576,87492,91.9695
Portugal,2099,81,41091,44886,85977,91.5452
Portugal,2099,82,40842,44711,85553,91.3466
Portugal,2099,83,39048,43819,82867,89.112
Portugal,2099,84,36913,41436,78349,89.0844
Portugal,2099,85,35428,41208,76636,85.9736
Portugal,2099,86,36579,42819,79398,85.427
Portugal,2099,87,36559,44121,80680,82.8608
Portugal,2099,88,34997,44570,79567,78.5214
Portugal,2099,89,31310,40891,72201,76.5694
Portugal,2099,90,29554,39722,69276,74.4021
Portugal,2099,91,25703,36354,62057,70.702
Portugal,2099,92,22889,34237,57126,66.8546
Portugal,2099,93,20588,31897,52485,64.5453
Portugal,2099,94,16966,28172,45138,60.2229
Portugal,2099,95,14130,24877,39007,56.7995
Portugal,2099,96,11165,20943,32108,53.3114
Portugal,2099,97,8387,16870,25257,49.7155
Portugal,2099,98,6526,14170,20696,46.055
Portugal,2099,99,4402,10384,14786,42.3921
Portugal,2099,100,6859,19058,25917,35.9901
Portugal,2100,0,26976,25372,52348,106.3219
Portugal,2100,1,27078,25478,52556,106.2799
Portugal,2100,2,27245,25641,52886,106.2556
Portugal,2100,3,27445,25832,53277,106.2442
Portugal,2100,4,27535,25926,53461,106.2061
Portugal,2100,5,27594,25978,53572,106.2206
Portugal,2100,6,27820,26189,54009,106.2278
Portugal,2100,7,27867,26233,54100,106.2288
Portugal,2100,8,28005,26362,54367,106.2325
Portugal,2100,9,28116,26468,54584,106.2264
Portugal,2100,10,28390,26727,55117,106.2222
Portugal,2100,11,28620,26948,55568,106.2045
Portugal,2100,12,28845,27168,56013,106.1727
Portugal,2100,13,29036,27354,56390,106.149
Portugal,2100,14,29210,27527,56737,106.114
Portugal,2100,15,29652,27950,57602,106.0894
Portugal,2100,16,29923,28220,58143,106.0347
Portugal,2100,17,30178,28478,58656,105.9695
Portugal,2100,18,30512,28815,59327,105.8893
Portugal,2100,19,30886,29193,60079,105.7993
Portugal,2100,20,31102,29419,60521,105.7208
Portugal,2100,21,31511,29830,61341,105.6353
Portugal,2100,22,31834,30156,61990,105.5644
Portugal,2100,23,32270,30594,62864,105.4782
Portugal,2100,24,32870,31187,64057,105.3965
Portugal,2100,25,33128,31450,64578,105.3355
Portugal,2100,26,33444,31771,65215,105.2658
Portugal,2100,27,33774,32101,65875,105.2117
Portugal,2100,28,34030,32362,66392,105.1542
Portugal,2100,29,34290,32619,66909,105.1228
Portugal,2100,30,34610,32934,67544,105.089
Portugal,2100,31,34871,33193,68064,105.0553
Portugal,2100,32,35103,33420,68523,105.0359
Portugal,2100,33,35208,33535,68743,104.9888
Portugal,2100,34,35404,33724,69128,104.9816
Portugal,2100,35,35661,33978,69639,104.9532
Portugal,2100,36,35832,34146,69978,104.9376
Portugal,2100,37,35977,34289,70266,104.9229
Portugal,2100,38,36311,34611,70922,104.9117
Portugal,2100,39,36391,34693,71084,104.8944
Portugal,2100,40,36499,34805,71304,104.8671
Portugal,2100,41,36794,35094,71888,104.8441
Portugal,2100,42,36993,35287,72280,104.8346
Portugal,2100,43,37248,35544,72792,104.7941
Portugal,2100,44,37454,35753,73207,104.7576
Portugal,2100,45,37681,35981,73662,104.7247
Portugal,2100,46,37995,36296,74291,104.681
Portugal,2100,47,38286,36592,74878,104.6294
Portugal,2100,48,38611,36926,75537,104.5632
Portugal,2100,49,38928,37258,76186,104.4823
Portugal,2100,50,39419,37748,77167,104.4267
Portugal,2100,51,39754,38107,77861,104.322
Portugal,2100,52,40005,38387,78392,104.215
Portugal,2100,53,40374,38789,79163,104.0862
Portugal,2100,54,40566,39028,79594,103.9408
Portugal,2100,55,40875,39383,80258,103.7884
Portugal,2100,56,41249,39799,81048,103.6433
Portugal,2100,57,41689,40294,81983,103.4621
Portugal,2100,58,41926,40599,82525,103.2686
Portugal,2100,59,42110,40867,82977,103.0416
Portugal,2100,60,42348,41191,83539,102.8089
Portugal,2100,61,42468,41414,83882,102.545
Portugal,2100,62,42408,41467,83875,102.2693
Portugal,2100,63,42587,41750,84337,102.0048
Portugal,2100,64,42707,41974,84681,101.7463
Portugal,2100,65,42677,42062,84739,101.4621
Portugal,2100,66,42579,42082,84661,101.181
Portugal,2100,67,42255,41891,84146,100.8689
Portugal,2100,68,42213,41982,84195,100.5502
Portugal,2100,69,41963,41893,83856,100.1671
Portugal,2100,70,41713,41797,83510,99.799
Portugal,2100,71,41532,41788,83320,99.3874
Portugal,2100,72,41267,41710,82977,98.9379
Portugal,2100,73,41071,41705,82776,98.4798
Portugal,2100,74,40805,41653,82458,97.9641
Portugal,2100,75,40749,41828,82577,97.4204
Portugal,2100,76,40639,41975,82614,96.8172
Portugal,2100,77,40502,42130,82632,96.1358
Portugal,2100,78,40379,42333,82712,95.3842
Portugal,2100,79,41746,44018,85764,94.8385
Portugal,2100,80,42258,44943,87201,94.0258
Portugal,2100,81,41315,45335,86650,91.1327
Portugal,2100,82,40371,44584,84955,90.5504
Portugal,2100,83,40004,44347,84351,90.2068
Portugal,2100,84,38088,43371,81459,87.819
Portugal,2100,85,35809,40890,76699,87.574
Portugal,2100,86,34087,40464,74551,84.2403
Portugal,2100,87,34860,41790,76650,83.4171
Portugal,2100,88,34499,42799,77298,80.607
Portugal,2100,89,32502,42796,75298,75.9464
Portugal,2100,90,28607,38835,67442,73.6629
Portugal,2100,91,26532,37205,63737,71.313
Portugal,2100,92,22705,33629,56334,67.5161
Portugal,2100,93,19992,31423,51415,63.6222
Portugal,2100,94,17579,28779,46358,61.0827
Portugal,2100,95,14026,24765,38791,56.6364
Portugal,2100,96,11265,21188,32453,53.1669
Portugal,2100,97,8591,17260,25851,49.774
Portugal,2100,98,6215,13419,19634,46.3149
Portugal,2100,99,4639,10830,15469,42.8347
Portugal,2100,100,7188,19952,27140,36.0265
Portugal,2101,0,26852,25253,52105,106.3319
Portugal,2101,1,27042,25439,52481,106.3013
Portugal,2101,2,27135,25536,52671,106.2617
Portugal,2101,3,27293,25690,52983,106.2398
Portugal,2101,4,27486,25874,53360,106.2302
Portugal,2101,5,27570,25961,53531,106.1978
Portugal,2101,6,27624,26008,53632,106.2135
Portugal,2101,7,27846,26215,54061,106.2216
Portugal,2101,8,27889,26255,54144,106.2236
Portugal,2101,9,28024,26381,54405,106.228
Portugal,2101,10,28133,26485,54618,106.2224
Portugal,2101,11,28407,26744,55151,106.2182
Portugal,2101,12,28640,26970,55610,106.1921
Portugal,2101,13,28872,27199,56071,106.151
Portugal,2101,14,29076,27399,56475,106.1207
Portugal,2101,15,29268,27591,56859,106.0781
Portugal,2101,16,29731,28039,57770,106.0345
Portugal,2101,17,30025,28335,58360,105.9644
Portugal,2101,18,30304,28619,58923,105.8877
Portugal,2101,19,30659,28977,59636,105.8046
Portugal,2101,20,31051,29374,60425,105.7091
Portugal,2101,21,31279,29614,60893,105.6223
Portugal,2101,22,31698,30033,61731,105.5439
Portugal,2101,23,32025,30362,62387,105.4772
Portugal,2101,24,32463,30800,63263,105.3994
Portugal,2101,25,33060,31389,64449,105.3235
Portugal,2101,26,33313,31646,64959,105.2676
Portugal,2101,27,33623,31959,65582,105.2067
Portugal,2101,28,33944,32279,66223,105.1582
Portugal,2101,29,34191,32529,66720,105.1093
Portugal,2101,30,34441,32776,67217,105.0799
Portugal,2101,31,34752,33079,67831,105.0576
Portugal,2101,32,35003,33328,68331,105.0258
Portugal,2101,33,35225,33544,68769,105.0113
Portugal,2101,34,35321,33649,68970,104.9689
Portugal,2101,35,35506,33829,69335,104.9573
Portugal,2101,36,35755,34074,69829,104.9334
Portugal,2101,37,35918,34234,70152,104.9191
Portugal,2101,38,36056,34369,70425,104.9085
Portugal,2101,39,36381,34683,71064,104.8958
Portugal,2101,40,36453,34758,71211,104.8766
Portugal,2101,41,36553,34864,71417,104.8445
Portugal,2101,42,36841,35146,71987,104.8227
Portugal,2101,43,37033,35334,72367,104.8084
Portugal,2101,44,37281,35586,72867,104.7631
Portugal,2101,45,37479,35790,73269,104.7192
Portugal,2101,46,37699,36014,73713,104.6787
Portugal,2101,47,38006,36324,74330,104.6305
Portugal,2101,48,38289,36615,74904,104.5719
Portugal,2101,49,38607,36945,75552,104.4986
Portugal,2101,50,38916,37274,76190,104.4052
Portugal,2101,51,39398,37761,77159,104.3352
Portugal,2101,52,39724,38116,77840,104.2187
Portugal,2101,53,39967,38393,78360,104.0997
Portugal,2101,54,40329,38791,79120,103.9648
Portugal,2101,55,40514,39028,79542,103.8075
Portugal,2101,56,40815,39380,80195,103.644
Portugal,2101,57,41180,39793,80973,103.4855
Portugal,2101,58,41611,40286,81897,103.289
Portugal,2101,59,41838,40587,82425,103.0823
Portugal,2101,60,42011,40852,82863,102.8371
Portugal,2101,61,42237,41172,83409,102.5867
Portugal,2101,62,42355,41395,83750,102.3191
Portugal,2101,63,42299,41449,83748,102.0507
Portugal,2101,64,42478,41731,84209,101.79
Portugal,2101,65,42597,41954,84551,101.5326
Portugal,2101,66,42565,42041,84606,101.2464
Portugal,2101,67,42461,42060,84521,100.9534
Portugal,2101,68,42131,41867,83998,100.6306
Portugal,2101,69,42074,41953,84027,100.2884
Portugal,2101,70,41819,41861,83680,99.8997
Portugal,2101,71,41559,41761,83320,99.5163
Portugal,2101,72,41365,41748,83113,99.0826
Portugal,2101,73,41094,41668,82762,98.6224
Portugal,2101,74,40880,41656,82536,98.1371
Portugal,2101,75,40601,41600,82201,97.5986
Portugal,2101,76,40521,41766,82287,97.0191
Portugal,2101,77,40376,41899,82275,96.3651
Portugal,2101,78,40204,42039,82243,95.635
Portugal,2101,79,40025,42217,82242,94.8078
Portugal,2101,80,41297,43858,85155,94.1607
Portugal,2101,81,41668,44714,86382,93.1878
Portugal,2101,82,40608,45039,85647,90.1619
Portugal,2101,83,39562,44232,83794,89.442
Portugal,2101,84,39041,43907,82948,88.9175
Portugal,2101,85,36972,42815,79787,86.3529
Portugal,2101,86,34479,40170,74649,85.8327
Portugal,2101,87,32513,39514,72027,82.2822
Portugal,2101,88,32927,40565,73492,81.171
Portugal,2101,89,32074,41128,73202,77.9858
Portugal,2101,90,29731,40681,70412,73.0833
Portugal,2101,91,25714,36411,62125,70.6215
Portugal,2101,92,23468,34455,57923,68.112
Portugal,2101,93,19860,30903,50763,64.2656
Portugal,2101,94,17096,28390,45486,60.2184
Portugal,2101,95,14556,25336,39892,57.4518
Portugal,2101,96,11201,21125,32326,53.0225
Portugal,2101,97,8682,17490,26172,49.6398
Portugal,2101,98,6377,13751,20128,46.3748
Portugal,2101,99,4424,10272,14696,43.0685
Portugal,2101,100,7560,20895,28455,36.1809
